ID	BARCODE	SEQCOUNT	CLUSTERS
AGCAGTCCAAATGTG	AGCAGTCCAAATGTG	1	1
TGTAGGTTGGTTATC	TGTAGGTTGGTTATC	1	1
TTGCAGTCATTGGAA	TTGCAGTCATTGGAA	1	1
AGACCGCCTGTTGTT	AGACCGCCTGTTGTT	1	1
GGTTGTTATGGGTTT	GGTTGTTATGGGTTT	1	1
TTATCAGGTACGTGA	TTATCAGGTACGTGA	1	1
TGCCGCGGTAACCTC	TGCCGCGGTAACCTC	1	1
TGAATGCCCACAATG	TGAATGCCCACAATG	1	1
ATCCCTAGCGTTTTA	ATCCCTAGCGTTTTA	2	1
ACGACAATTAGAATT	ACGACAATTAGAATT	2	1
TGGAATCACACGTCG	TGGAATCACACGTCG	2	1
GTATACACACCGAAG	GTATACACACCGAAG	2	1
AATAAATATACGTGC	AATAAATATACGTGC	2	1
ACCGTAAAAATGTAC	ACCGTAAAAATGTAC	1	1
ATAGATCTTTTATGT	ATAGATCTTTTATGT	2	1
ACCAGAGACGGTGAA	ACCAGAGACGGTGAA	9	1
ATTCAATACTCTCTA	ATTCAATACTCTCTA	1	1
AAGCAACCTGTCATG	AAGCAACCTGTCATG	5	1
TCGTTACAAAATACA	TCGTTACAAAATACA	4	1
CTCCACGAATGGTGA	CTCCACGAATGGTGA	3	1
TGAGCTTTATTTAGA	TGAGCTTTATTTAGA	1	1
TTTGTCGCCTGAGAG	TTTGTCGCCTGAGAG	1	1
CAGTTGGATCGTGCT	CAGTTGGATCGTGCT	3	1
AGTATACCGTAACTC	AGTATACCGTAACTC	3	1
TGTCCGCAAACGTCA	TGTCCGCAAACGTCA	48	1
TATGATGGCGTGATT	TATGATGGCGTGATT	24	1
CTATCCATTCTGTGT	CTATCCATTCTGTGT	1	1
ATCGCAGCGTGTCGG	ATCGCAGCGTGTCGG	1	1
ACTATAAGTTTTTAG	ACTATAAGTTTTTAG	2	1
AGACTATGAGCCATA	AGACTATGAGCCATA	48	1
AATGTTTAGTTCGCT	AATGTTTAGTTCGCT	6	1
ATCTGTTTCTTCTTT	ATCTGTTTCTTCTTT	3	1
TTCCAGGAATGATGG	TTCCAGGAATGATGG	30	1
AGAAGATGTAATACT	AGAAGATGTAATACT	1	1
ATACTACCATCAACT	ATACTACCATCAACT	1	1
ATCACCATATTAACA	ATCACCATATTAACA	3	1
GCGCGAGTCGGCTTG	GCGCGAGTCGGCTTG	98	1
ATTAGGGTAGTATTA	ATTAGGGTAGTATTA	2	1
CGTTTCGCAGTCTGT	CGTTTCGCAGTCTGT	1	1
CCTATCGTTTTGGGA	CCTATCGTTTTGGGA	2	1
GGATCCGGCCAGACG	GGATCCGGCCAGACG	110	1
CTGATTTGTAGTTCT	CTGATTTGTAGTTCT	3	1
ATAGTTTCGTAGGAA	ATAGTTTCGTAGGAA	1	1
ATAGAATACGCACCA	ATAGAATACGCACCA	1	1
GCTGGATGCATATAC	GCTGGATGCATATAC	3	1
GCAGCTAGTGTTGAA	GCAGCTAGTGTTGAA	3	1
GGGCCGCGTGAGCGT	GGGCCGCGTGAGCGT	1	1
TCGCAATATTTAGAA	TCGCAATATTTAGAA	1	1
TTATGCGAACGAAGG	TTATGCGAACGAAGG	1	1
GAGGTGAAGAGTTTC	GAGGTGAAGAGTTTC	2	1
GGGTGGATGTTTGTT	GGGTGGATGTTTGTT	2	1
GATGCGTCGTGCTGA	GATGCGTCGTGCTGA	2	1
TTGGTCTCTAGGTTA	TTGGTCTCTAGGTTA	1	1
AGGTCAACTTTATAT	AGGTCAACTTTATAT	4	1
ATCCGCCAAATAAAA	ATCCGCCAAATAAAA	2	1
TCAACCTTGTCCCTA	TCAACCTTGTCCCTA	27	1
ATCCTGTTGTTGGTG	ATCCTGTTGTTGGTG	35	1
CGGGAGGGTGGAAGC	CGGGAGGGTGGAAGC	123	1
TATCAGAGCGAATAT	TATCAGAGCGAATAT	5	1
GGTGTTTTGGATACA	GGTGTTTTGGATACA	6	1
CGAGTGCTGGTCAAA	CGAGTGCTGGTCAAA	1	1
TGTCTCTTGGTTGAT	TGTCTCTTGGTTGAT	1	1
TCCTCCATGTACCCT	TCCTCCATGTACCCT	4	1
GGACTGTTACTGTTA	GGACTGTTACTGTTA	2	1
GCGCTCTCGCTCACT	GCGCTCTCGCTCACT	59	1
TCATACAAATGGTTA	TCATACAAATGGTTA	27	1
GCACATTTGCTTGTA	GCACATTTGCTTGTA	1	1
GGGGAAACTTTTTGT	GGGGAAACTTTTTGT	12	1
GGGGTGTGGCGATGT	GGGGTGTGGCGATGT	128	1
GCTTTATCATTTGTC	GCTTTATCATTTGTC	3	1
TTCGCTGTCAGTGGA	TTCGCTGTCAGTGGA	2	1
TGGAAATGACCGATT	TGGAAATGACCGATT	2	1
GGGTTTGGCGATCGT	GGGTTTGGCGATCGT	1	1
GTGTGATGAAATCCG	GTGTGATGAAATCCG	4	1
AGCGGACAACTATAT	AGCGGACAACTATAT	48	1
TGTTAGTTCCAAGTT	TGTTAGTTCCAAGTT	1	1
AGTTACGTTATCGAT	AGTTACGTTATCGAT	1	1
TTGTGAGGATAATTT	TTGTGAGGATAATTT	3	1
TGGTATCTAACGTCG	TGGTATCTAACGTCG	1	1
AGATCAATTGAGTTT	AGATCAATTGAGTTT	1	1
GTTGTGTCGAGCGGG	GTTGTGTCGAGCGGG	1	1
ATCAGGGAGGTACAA	ATCAGGGAGGTACAA	3	1
AGTTCCGTAGATTGT	AGTTCCGTAGATTGT	16	1
GGTCTAACTATCTTA	GGTCTAACTATCTTA	1	1
GGGCGATACGGTTTA	GGGCGATACGGTTTA	2	1
ATCATGCCGAGGTCC	ATCATGCCGAGGTCC	7	1
CCAGAACGGTGATGG	CCAGAACGGTGATGG	1	1
TCCGCAGGTAGAGCG	TCCGCAGGTAGAGCG	1	1
ACTGGAATTTATTAC	ACTGGAATTTATTAC	2	1
ATGCCCCCTAAATGC	ATGCCCCCTAAATGC	3	1
ATTATTTGTATGCTT	ATTATTTGTATGCTT	2	1
ATCGTTAAATGTAAA	ATCGTTAAATGTAAA	7	1
CGCGTCGCTGAAGTG	CGCGTCGCTGAAGTG	169	1
TCAATTAAGTCTCTG	TCAATTAAGTCTCTG	2	1
CATGGTTTAGATATA	CATGGTTTAGATATA	1	1
TAAGGATCGTAACTC	TAAGGATCGTAACTC	1	1
GGGTATCATATTACA	GGGTATCATATTACA	4	1
TAGGGAAAGGTTGTG	TAGGGAAAGGTTGTG	1	1
ATACGATTCTTCTTT	ATACGATTCTTCTTT	1	1
CGTGATGGAAGAGGT	CGTGATGGAAGAGGT	3	1
GACTTTTTCAATTGA	GACTTTTTCAATTGA	3	1
ATTATTGCAAAAATT	ATTATTGCAAAAATT	1	1
AATGGGAGCCTATAG	AATGGGAGCCTATAG	1	1
TGAGTAATTGGAGCT	TGAGTAATTGGAGCT	2	1
AAACATCTCCTCTCG	AAACATCTCCTCTCG	2	1
ACATGGGATCATTCA	ACATGGGATCATTCA	1	1
TACAGTAATTATGTT	TACAGTAATTATGTT	5	1
ACGCTAATATCCATT	ACGCTAATATCCATT	1	1
TCCGCTCGAAATACA	TCCGCTCGAAATACA	1	1
TAATGGGTTTCCGTA	TAATGGGTTTCCGTA	2	1
TCGTAGGTACGTAAA	TCGTAGGTACGTAAA	89	1
GTGGTGGGGGTCACC	GTGGTGGGGGTCACC	1	1
GAATGGAAAAAACTC	GAATGGAAAAAACTC	1	1
CAGATAAAACTAATT	CAGATAAAACTAATT	6	1
TGACCGTGATGAAAA	TGACCGTGATGAAAA	2	1
CAGGGAGTGATTGGG	CAGGGAGTGATTGGG	3	1
ACAATGTCTCTCACC	ACAATGTCTCTCACC	1	1
AACATTGCGTCCACG	AACATTGCGTCCACG	5	1
GGATCTGCCATGTCT	GGATCTGCCATGTCT	1	1
CAATATTTGTATCTT	CAATATTTGTATCTT	3	1
AATAGCGTATTTAGT	AATAGCGTATTTAGT	2	1
GTCTAACGCCATTTT	GTCTAACGCCATTTT	4	1
TATCATACACCCATA	TATCATACACCCATA	1	1
GATGAAGTCAATCGG	GATGAAGTCAATCGG	53	1
TTCATCTGGGGCTTT	TTCATCTGGGGCTTT	3	1
CACTTCTTTAAGAAA	CACTTCTTTAAGAAA	1	1
TTCCGAAGTAGGTGA	TTCCGAAGTAGGTGA	1	1
GCACAAGACGGCCAT	GCACAAGACGGCCAT	6	1
TTTGTTGAGTTTAAT	TTTGTTGAGTTTAAT	1	1
AAAAGCTGCACAGAG	AAAAGCTGCACAGAG	3	1
AAAACATTATAAAAG	AAAACATTATAAAAG	2	1
TTGGTAGTTGTGGTA	TTGGTAGTTGTGGTA	1	1
CTATTTATCATAAGT	CTATTTATCATAAGT	1	1
GGTTCTGAGTGGTGC	GGTTCTGAGTGGTGC	1	1
ATTGATTGCTTTTAT	ATTGATTGCTTTTAT	1	1
GCATAATTCACATTC	GCATAATTCACATTC	2	1
CTCAAGTTTTCTCTG	CTCAAGTTTTCTCTG	2	1
ACATGGGTTACGTAC	ACATGGGTTACGTAC	1	1
GAGTCTAGAGACGTA	GAGTCTAGAGACGTA	52	1
TATATATATGCACTT	TATATATATGCACTT	1	1
CTTTACACGTGATCT	CTTTACACGTGATCT	1	1
AGGTGTTTAGTTATT	AGGTGTTTAGTTATT	2	1
GGGGAAGAGTCGCGT	GGGGAAGAGTCGCGT	2	1
GCGCCGTACCATGTG	GCGCCGTACCATGTG	7	1
AGTCTCCGGATCCGT	AGTCTCCGGATCCGT	6	1
GGTGGCGGGTTAGCG	GGTGGCGGGTTAGCG	1	1
CATTCGTCGTTTTAT	CATTCGTCGTTTTAT	2	1
TACTGTCACTCACTA	TACTGTCACTCACTA	1	1
AAAATGTGTAAAAAT	AAAATGTGTAAAAAT	4	1
GGAGCCTGTGACTTT	GGAGCCTGTGACTTT	2	1
AGTCCTGGCGCATGT	AGTCCTGGCGCATGT	3	1
CTTTTCTTTTCAACT	CTTTTCTTTTCAACT	1	1
TCAACTTAGGAATCT	TCAACTTAGGAATCT	1	1
CATATCCACGTAAAG	CATATCCACGTAAAG	13	1
AACCGCAAGGTATCA	AACCGCAAGGTATCA	1	1
TCCGTATTTATTGAT	TCCGTATTTATTGAT	5	1
GACAGGATAGACAGG	GACAGGATAGACAGG	1	1
CACACGGTCTGGTCT	CACACGGTCTGGTCT	2	1
GGCAGATTTCTTCAC	GGCAGATTTCTTCAC	6	1
GTTAGCGTATTGATT	GTTAGCGTATTGATT	1	1
AGTAAGATCAAGACG	AGTAAGATCAAGACG	2	1
TGATATCTATAATCG	TGATATCTATAATCG	2	1
TACGTAACTATTATA	TACGTAACTATTATA	2	1
AATTATATTCTAAAA	AATTATATTCTAAAA	1	1
GCGTCGCAATCTGGA	GCGTCGCAATCTGGA	3	1
ATACTCAGTTAGTTT	ATACTCAGTTAGTTT	1	1
TACGATACACCGCTT	TACGATACACCGCTT	1	1
TCAGTTAGAACGATA	TCAGTTAGAACGATA	5	1
ATCATGCATCAGGTG	ATCATGCATCAGGTG	2	1
GATTGTTTCCTAGCG	GATTGTTTCCTAGCG	1	1
GGTTAGGTTCGGGAG	GGTTAGGTTCGGGAG	3	1
ATTTTAGGTCATAGT	ATTTTAGGTCATAGT	1	1
CGCTGTTATCATGTT	CGCTGTTATCATGTT	1	1
TGGGCAACGCTTCTA	TGGGCAACGCTTCTA	2	1
AAAATTGTGGCACTA	AAAATTGTGGCACTA	3	1
ATGCTAATGTCAGTA	ATGCTAATGTCAGTA	15	1
AGTCGTGTTACGCTT	AGTCGTGTTACGCTT	2	1
AAGGAATGGACTGTG	AAGGAATGGACTGTG	1	1
GTGATGGGTGGAAGT	GTGATGGGTGGAAGT	2	1
AGAGGGACGTGAAAG	AGAGGGACGTGAAAG	6	1
GTCCTTCCCATCGTC	GTCCTTCCCATCGTC	2	1
AACAGTTATTCAAGT	AACAGTTATTCAAGT	7	1
GCCAGTGAGCTAGTG	GCCAGTGAGCTAGTG	1	1
CTTTTTGGCGAGATT	CTTTTTGGCGAGATT	1	1
ATTGTCACGGTGTAA	ATTGTCACGGTGTAA	1	1
AGGATGAAACACATT	AGGATGAAACACATT	1	1
GCATTAGAGGTAGAA	GCATTAGAGGTAGAA	1	1
AAGGATTCATCTTGC	AAGGATTCATCTTGC	30	1
CAAAATAACAAAGAC	CAAAATAACAAAGAC	2	1
TATGTATCGTACTAT	TATGTATCGTACTAT	3	1
ATGTTTCTTCTAGCA	ATGTTTCTTCTAGCA	1	1
TCACTGCGGTATATA	TCACTGCGGTATATA	3	1
ATTGAGGCTACGCCT	ATTGAGGCTACGCCT	6	1
TGGTTGGGTCGAAGC	TGGTTGGGTCGAAGC	6	1
GCGGGTGGAGTAAGG	GCGGGTGGAGTAAGG	4	1
CAATTTTCGGAAGCG	CAATTTTCGGAAGCG	1	1
TTGTGGGGGGGCTGA	TTGTGGGGGGGCTGA	2	1
CGAGTTGTTGAGTAA	CGAGTTGTTGAGTAA	4	1
ACTTGCGAGGTATCA	ACTTGCGAGGTATCA	1	1
ACAGCGGAGTAGCTT	ACAGCGGAGTAGCTT	1	1
GTTTACTATACATTG	GTTTACTATACATTG	3	1
AGACTTGGCTCACAA	AGACTTGGCTCACAA	3	1
ATAACCTTTCGAAAA	ATAACCTTTCGAAAA	1	1
TGGTTGGGTAAAACG	TGGTTGGGTAAAACG	2	1
TTTTCAAAGCACCAA	TTTTCAAAGCACCAA	1	1
GGTGTTGGGATTTCT	GGTGTTGGGATTTCT	3	1
AGAAAACATATGGAG	AGAAAACATATGGAG	4	1
TTGACGTCTTAACCT	TTGACGTCTTAACCT	1	1
TTGATCTGACAGACT	TTGATCTGACAGACT	2	1
CCTGCTGTAATTTCT	CCTGCTGTAATTTCT	4	1
AACTGGGCCTGCGGT	AACTGGGCCTGCGGT	3	1
GCCTGTACCCCTAAA	GCCTGTACCCCTAAA	5	1
GTTCAAGCCGTATGT	GTTCAAGCCGTATGT	2	1
TGCATTGGGACCTCC	TGCATTGGGACCTCC	1	1
TAATTTTAGGCTTTC	TAATTTTAGGCTTTC	2	1
TAGAGATATAACCTC	TAGAGATATAACCTC	2	1
GCCTGGGAGCCTGGG	GCCTGGGAGCCTGGG	1	1
GTAGTAAATGATGTA	GTAGTAAATGATGTA	2	1
ATCAGAATACTTGAT	ATCAGAATACTTGAT	1	1
TATAATCAATCATAT	TATAATCAATCATAT	1	1
TCACCACATAGTCTT	TCACCACATAGTCTT	5	1
ACATGACGTAAACCT	ACATGACGTAAACCT	3	1
TGATTCGGTGTTGGG	TGATTCGGTGTTGGG	1	1
ATCACGTTCGGTCAT	ATCACGTTCGGTCAT	1	1
TAATAGTCCATGAGT	TAATAGTCCATGAGT	2	1
CTTTCGCTACTTGGT	CTTTCGCTACTTGGT	3	1
GCATAACCACTTGTC	GCATAACCACTTGTC	4	1
GCAGAGTTTTTGCAA	GCAGAGTTTTTGCAA	30	1
GACGCAATGGTCCTC	GACGCAATGGTCCTC	2	1
AGTAGCCGCCTGGTT	AGTAGCCGCCTGGTT	1	1
TTTACAGACTTTTCT	TTTACAGACTTTTCT	1	1
AGATCACTGTACGCT	AGATCACTGTACGCT	1	1
ATTTTATTTGTAGGT	ATTTTATTTGTAGGT	3	1
CTTCCATGGTTTAAT	CTTCCATGGTTTAAT	2	1
TCGTATGTGAAAACC	TCGTATGTGAAAACC	2	1
AAATAATAATCCTGG	AAATAATAATCCTGG	1	1
GTCAATAGTAGAAAT	GTCAATAGTAGAAAT	1	1
TCTGCTGATGCTGTT	TCTGCTGATGCTGTT	4	1
GATTTCTCAATTCGT	GATTTCTCAATTCGT	2	1
GAATTCGTCCGTATT	GAATTCGTCCGTATT	5	1
CCTTTAACAGAGGTT	CCTTTAACAGAGGTT	3	1
TCACTAATGCACTTA	TCACTAATGCACTTA	1	1
TTGGTTTACAATCAT	TTGGTTTACAATCAT	2	1
TACTCTGTGCGTGTG	TACTCTGTGCGTGTG	1	1
TGATAATAGTTTACT	TGATAATAGTTTACT	2	1
GAAGATGGCGTTGAC	GAAGATGGCGTTGAC	1	1
GGCGCTAAGACGTAC	GGCGCTAAGACGTAC	4	1
TCGCTACATTCGTGC	TCGCTACATTCGTGC	3	1
GTTACTGGTTTGGCG	GTTACTGGTTTGGCG	2	1
CCTTGCTGGGCGTGA	CCTTGCTGGGCGTGA	1	1
GAAACATATGTGTGT	GAAACATATGTGTGT	14	1
AACTCATTTCAGTTA	AACTCATTTCAGTTA	1	1
CGGAGCCATTATATT	CGGAGCCATTATATT	3	1
CAAATTTCTGAAACA	CAAATTTCTGAAACA	1	1
TTCAACGATGTCTCA	TTCAACGATGTCTCA	3	1
CTTAGAGATCTACTG	CTTAGAGATCTACTG	8	1
AAGGCCCCAGGCAAG	AAGGCCCCAGGCAAG	1	1
GTAAGTACTCGGGCG	GTAAGTACTCGGGCG	4	1
TTCATTGACGTCGAT	TTCATTGACGTCGAT	17	1
TCCATAAATTGAACC	TCCATAAATTGAACC	2	1
TTGTCTAAGTATGAT	TTGTCTAAGTATGAT	1	1
GTTATCCTTTCGCGA	GTTATCCTTTCGCGA	1	1
TCCACGATTTTTGGG	TCCACGATTTTTGGG	2	1
AGCCTGTCAGCTCTG	AGCCTGTCAGCTCTG	5	1
TCATCGCTTCGTTGC	TCATCGCTTCGTTGC	43	1
CGGCGGCGAAGTGTG	CGGCGGCGAAGTGTG	11	1
TTCTGCAATGCTCAC	TTCTGCAATGCTCAC	3	1
GTGTAGTTTCCATAC	GTGTAGTTTCCATAC	1	1
GGGTTGGCCCTTACC	GGGTTGGCCCTTACC	4	1
TCCGTCAAATTTTCG	TCCGTCAAATTTTCG	24	1
TAAATCTCTCAACGG	TAAATCTCTCAACGG	1	1
GGTTCAATTTATTCG	GGTTCAATTTATTCG	1	1
ATATAAACATATCTG	ATATAAACATATCTG	1	1
GCGTGGAGGGGGCAG	GCGTGGAGGGGGCAG	1	1
CGTTCCGTGGATGTT	CGTTCCGTGGATGTT	2	1
ACTAAATTTAATTCT	ACTAAATTTAATTCT	3	1
AAAGATTAAACATCT	AAAGATTAAACATCT	3	1
TGGCCTATGGAGTCC	TGGCCTATGGAGTCC	2	1
TACGGTTCACCTCAC	TACGGTTCACCTCAC	4	1
TCGGGAGGCGAACTC	TCGGGAGGCGAACTC	1	1
GTAGATGTGGTGGGA	GTAGATGTGGTGGGA	3	1
TCTGGGGGGAGTGTG	TCTGGGGGGAGTGTG	2	1
TCTTGCATGCCATTC	TCTTGCATGCCATTC	1	1
ATAAAGCAGCTGTGA	ATAAAGCAGCTGTGA	1	1
TAGGTAAGTTTATCA	TAGGTAAGTTTATCA	2	1
TCAATGTGAGTGAGC	TCAATGTGAGTGAGC	2	1
TCTAGCAAGCTTGGA	TCTAGCAAGCTTGGA	4	1
ACGTTCTCAGGTGAT	ACGTTCTCAGGTGAT	2	1
ACATAATGGCAGCGA	ACATAATGGCAGCGA	1	1
AGCTAAATTTCCTAC	AGCTAAATTTCCTAC	1	1
AACACATTTATTAAT	AACACATTTATTAAT	1	1
AGTTGTCAACTGACC	AGTTGTCAACTGACC	4	1
AAAGTTAAGTCTACT	AAAGTTAAGTCTACT	1	1
CATATTTACAGTGGT	CATATTTACAGTGGT	3	1
AACGTCGTGTTACTA	AACGTCGTGTTACTA	4	1
GGTTTGAAGCAGGTG	GGTTTGAAGCAGGTG	2	1
ATTTCCGTTTCTATC	ATTTCCGTTTCTATC	1	1
CGATGTATATCTTTA	CGATGTATATCTTTA	2	1
TGAGCTAAGGGTAGG	TGAGCTAAGGGTAGG	1	1
AAGCATAAGCTAGTA	AAGCATAAGCTAGTA	2	1
GCATCGTCTGTAGTT	GCATCGTCTGTAGTT	1	1
TCATCTCCTATGTCC	TCATCTCCTATGTCC	6	1
TTCAGACTTTGCTGC	TTCAGACTTTGCTGC	1	1
GTAATTAAGGTAGGA	GTAATTAAGGTAGGA	2	1
ATGTTACACAACTCT	ATGTTACACAACTCT	2	1
CCTTGGATAGAAGTA	CCTTGGATAGAAGTA	2	1
TAGGATGTTCATCAC	TAGGATGTTCATCAC	8	1
CCCGCGTGGGCGTAT	CCCGCGTGGGCGTAT	3	1
GTTTCTTGTGATTGA	GTTTCTTGTGATTGA	4	1
TCCAATTCATGTCGC	TCCAATTCATGTCGC	4	1
GTCTGGTGGGGGTTA	GTCTGGTGGGGGTTA	2	1
GAGATCGGTCACACT	GAGATCGGTCACACT	3	1
ACCTTTACCCTAGAT	ACCTTTACCCTAGAT	3	1
TACATGCATCCCATA	TACATGCATCCCATA	1	1
GATCGCTTGCTATAT	GATCGCTTGCTATAT	2	1
CTGCATCGTTCTCTC	CTGCATCGTTCTCTC	25	1
CGCTCTCTAGTATAT	CGCTCTCTAGTATAT	10	1
AGTGATAACAATCTG	AGTGATAACAATCTG	1	1
TGCGCCTGGAATCAG	TGCGCCTGGAATCAG	12	1
TTGCCAGTTGTCGGT	TTGCCAGTTGTCGGT	3	1
TTTAGGTGCCTTATG	TTTAGGTGCCTTATG	3	1
GTTTCGGGTTACAGA	GTTTCGGGTTACAGA	1	1
CAATGAGAGCACTTT	CAATGAGAGCACTTT	3	1
ATTTAAACCCGCTGT	ATTTAAACCCGCTGT	4	1
GGTGCGGTTACGATC	GGTGCGGTTACGATC	51	1
GGAGAAGGCGGGTAT	GGAGAAGGCGGGTAT	1	1
AGAAGTGTTTGCTGG	AGAAGTGTTTGCTGG	22	1
GACTCATAAGTGCGA	GACTCATAAGTGCGA	1	1
CCGTCGAGTAGTATA	CCGTCGAGTAGTATA	1	1
TGTAAAAGTTAGACC	TGTAAAAGTTAGACC	2	1
AAAGGGCTAAAGTTG	AAAGGGCTAAAGTTG	2	1
AGGTCTACAGATGCG	AGGTCTACAGATGCG	4	1
CCCCGCGTTTTCCCT	CCCCGCGTTTTCCCT	57	1
AAACAACTAGAATTT	AAACAACTAGAATTT	2	1
GTGAGTGGAGGGCAA	GTGAGTGGAGGGCAA	1	1
CGAGCGGCGATTGAT	CGAGCGGCGATTGAT	19	1
GTACGTCATGATATT	GTACGTCATGATATT	1	1
CAAGGGATACAGCGT	CAAGGGATACAGCGT	7	1
AATCCAATCAATGGA	AATCCAATCAATGGA	1	1
TTATTTAAGCTAGTC	TTATTTAAGCTAGTC	2	1
AAACTGCTTGACCCG	AAACTGCTTGACCCG	4	1
TGAAGCTATCATAAA	TGAAGCTATCATAAA	2	1
TGGGTCTTAATTTCT	TGGGTCTTAATTTCT	1	1
CAATGTATTGTTCAA	CAATGTATTGTTCAA	2	1
TTCGTTCGTACCACT	TTCGTTCGTACCACT	3	1
ATGTTTAACGTACGA	ATGTTTAACGTACGA	1	1
ATAGTATACAATTGA	ATAGTATACAATTGA	4	1
CGAGGAAATGTTTAG	CGAGGAAATGTTTAG	2	1
CAGCTTCCTCTTATA	CAGCTTCCTCTTATA	4	1
CTGTTGACACTCTTC	CTGTTGACACTCTTC	33	1
GTTACAACTCTCTCT	GTTACAACTCTCTCT	3	1
GGTTGTTCGACGCTT	GGTTGTTCGACGCTT	26	1
CTATAGTGTTCCATC	CTATAGTGTTCCATC	1	1
CCGCATTTTTACATT	CCGCATTTTTACATT	3	1
GATCAGAGATTGCTC	GATCAGAGATTGCTC	2	1
TCTGAGGGCATACTC	TCTGAGGGCATACTC	2	1
CTTGGTGGGTCTGCT	CTTGGTGGGTCTGCT	6	1
GCCAAAAAATATACT	GCCAAAAAATATACT	1	1
GCACTAGAGACTTCT	GCACTAGAGACTTCT	2	1
TCATGCGGAGTTTCG	TCATGCGGAGTTTCG	1	1
TCCATATGTTGCGTG	TCCATATGTTGCGTG	3	1
GGAGGGGGCGTTCCC	GGAGGGGGCGTTCCC	3	1
AAACTGGAACTTTTC	AAACTGGAACTTTTC	1	1
GGGCGGGGGACGGTG	GGGCGGGGGACGGTG	1	1
GTTCTAGCTGATGCT	GTTCTAGCTGATGCT	1	1
CTGGGGGAAGGAGTG	CTGGGGGAAGGAGTG	6	1
CTATCATACCTCTCT	CTATCATACCTCTCT	3	1
CTATATCCGTATTTC	CTATATCCGTATTTC	1	1
TCTGGCGTAACACTT	TCTGGCGTAACACTT	2	1
AGCTAATTTGTTATG	AGCTAATTTGTTATG	7	1
TACAGCGAGGCAGGG	TACAGCGAGGCAGGG	4	1
CTTATAGTTGAACAG	CTTATAGTTGAACAG	6	1
TATTTTAATTATCAT	TATTTTAATTATCAT	4	1
CTACCTATGAGACTT	CTACCTATGAGACTT	5	1
AAAAAATGTGTCTAT	AAAAAATGTGTCTAT	1	1
ACCTATGGTACTGCT	ACCTATGGTACTGCT	1	1
GGCTGTATGTCGCTA	GGCTGTATGTCGCTA	7	1
GCCCATTACTAGGGG	GCCCATTACTAGGGG	5	1
CTTTAGCTAAAGTTG	CTTTAGCTAAAGTTG	4	1
TCACAGACTATAGTG	TCACAGACTATAGTG	2	1
TCTAACTAGTTACTC	TCTAACTAGTTACTC	1	1
ACATAATCTTCTATA	ACATAATCTTCTATA	1	1
TTTTCTCAATTGCTG	TTTTCTCAATTGCTG	3	1
GGATAAAGATCAGTG	GGATAAAGATCAGTG	1	1
TTATAAGTTTTTCAA	TTATAAGTTTTTCAA	1	1
TCAATATCCTTATCT	TCAATATCCTTATCT	3	1
GCCGGCTTTCACTGT	GCCGGCTTTCACTGT	2	1
GATATATAACTTTTC	GATATATAACTTTTC	1	1
TGGCGTAGTGACCGG	TGGCGTAGTGACCGG	1	1
GTAACAGTCAGTGTA	GTAACAGTCAGTGTA	2	1
TGTTGTGAAGCGCCG	TGTTGTGAAGCGCCG	2	1
ACATGGAATATTGAT	ACATGGAATATTGAT	3	1
ATGAAACATGGTCTT	ATGAAACATGGTCTT	1	1
TACGTGTTGCCTCTG	TACGTGTTGCCTCTG	1	1
GCGTTTTTGCACTTG	GCGTTTTTGCACTTG	2	1
CTTGTCGCTGTAATC	CTTGTCGCTGTAATC	2	1
GAGTAGGGTCCTTGA	GAGTAGGGTCCTTGA	14	1
TCGCACGGTGGGGTG	TCGCACGGTGGGGTG	5	1
AGAACATGCGTCCTA	AGAACATGCGTCCTA	1	1
TTATCTGCCCCTCTA	TTATCTGCCCCTCTA	1	1
GAAGCTTAAGAGGTA	GAAGCTTAAGAGGTA	1	1
ATTGATCTGTCTTTT	ATTGATCTGTCTTTT	1	1
GTCGGGATCACAGGG	GTCGGGATCACAGGG	2	1
ACATCTTAAATCCGA	ACATCTTAAATCCGA	3	1
AAACCTGACATCTCC	AAACCTGACATCTCC	1	1
TCGCAAATTACCATA	TCGCAAATTACCATA	2	1
TTACACTTTTTGGTC	TTACACTTTTTGGTC	1	1
ACATTGTAATTGTCT	ACATTGTAATTGTCT	1	1
CTAGGATACATTCCG	CTAGGATACATTCCG	2	1
ATAGGAATTGTTGTA	ATAGGAATTGTTGTA	2	1
GAGAAATGTTTTGTA	GAGAAATGTTTTGTA	4	1
CCCGTATACGTTGTC	CCCGTATACGTTGTC	2	1
ACTCTTGTTTTTGCC	ACTCTTGTTTTTGCC	1	1
TTCACATATACAAAA	TTCACATATACAAAA	1	1
CAAACATGGGTCTTT	CAAACATGGGTCTTT	1	1
TACGTCGAAGTTATT	TACGTCGAAGTTATT	1	1
TCAAGTTCAACGTCA	TCAAGTTCAACGTCA	1	1
CTTGGTACTATGGAG	CTTGGTACTATGGAG	2	1
GCCATAGTGCTGTAA	GCCATAGTGCTGTAA	3	1
TGTGTGTATGGAGGG	TGTGTGTATGGAGGG	121	1
AAATTAGGTAGTTAT	AAATTAGGTAGTTAT	1	1
CCAACAGTACTTTAT	CCAACAGTACTTTAT	2	1
TAAATAGCGTCCGTT	TAAATAGCGTCCGTT	9	1
GCTGGGGGGGTGGTT	GCTGGGGGGGTGGTT	2	1
TGTTAAGAGATATAA	TGTTAAGAGATATAA	1	1
AACTTTGTCTTTATT	AACTTTGTCTTTATT	3	1
ACTAGTCTACATAGG	ACTAGTCTACATAGG	1	1
TTAACGGTTAACAGT	TTAACGGTTAACAGT	4	1
TTTCTTGCGGATTAG	TTTCTTGCGGATTAG	2	1
GTTCGGGATTATTTA	GTTCGGGATTATTTA	1	1
GTCTCCGGGGAAGCT	GTCTCCGGGGAAGCT	1	1
ATGTATTGGGAATTA	ATGTATTGGGAATTA	1	1
CATGCGGGCGGGCGG	CATGCGGGCGGGCGG	1	1
GGTGGGGAAGTTTTG	GGTGGGGAAGTTTTG	3	1
GTGGGAGGGGGGGCG	GTGGGAGGGGGGGCG	2	1
CAATATCACTATTAT	CAATATCACTATTAT	1	1
TTATCCCAACTGTCC	TTATCCCAACTGTCC	5	1
GTATGGGAGATGTGG	GTATGGGAGATGTGG	1	1
TTTAGTGATTCCATT	TTTAGTGATTCCATT	3	1
CGGAAGTAAACCCCT	CGGAAGTAAACCCCT	3	1
TATGTGTGCTTTTTT	TATGTGTGCTTTTTT	4	1
TGAATATTATGCCGC	TGAATATTATGCCGC	5	1
TGTGGTAAGCAATCT	TGTGGTAAGCAATCT	1	1
GCTGTGGGGTCTTCA	GCTGTGGGGTCTTCA	5	1
CTGATTCCTGAACGC	CTGATTCCTGAACGC	3	1
ATTGCTGAGGTAGGC	ATTGCTGAGGTAGGC	2	1
AATTAACTATGCGTT	AATTAACTATGCGTT	3	1
CAGGTTTCGGAAGTG	CAGGTTTCGGAAGTG	1	1
TTAGCGACTAAAAAA	TTAGCGACTAAAAAA	1	1
GTCATTGTTCTACTT	GTCATTGTTCTACTT	2	1
GAGGCATGCAGTCTG	GAGGCATGCAGTCTG	1	1
TCCCTTATTTCTTGT	TCCCTTATTTCTTGT	2	1
GTACTTAATGTTTAT	GTACTTAATGTTTAT	1	1
ATAGCGATTTCTTGT	ATAGCGATTTCTTGT	10	1
ATTAGTTAATCTTGT	ATTAGTTAATCTTGT	10	1
ATCTTCTACCTATGT	ATCTTCTACCTATGT	1	1
CTTCGTTCTACAATA	CTTCGTTCTACAATA	3	1
GGGTCTGTCGTGGAG	GGGTCTGTCGTGGAG	4	1
AGCCGAGGGGAATGG	AGCCGAGGGGAATGG	1	1
ACCCTAGCATATCGA	ACCCTAGCATATCGA	1	1
ACCTCTAAGTGTGTA	ACCTCTAAGTGTGTA	4	1
CTGCTGGAATATTAT	CTGCTGGAATATTAT	2	1
ATAACCCATGTTTCG	ATAACCCATGTTTCG	4	1
GGAAGGTAACGTGCA	GGAAGGTAACGTGCA	15	1
CACTATGCGCAGCTG	CACTATGCGCAGCTG	2	1
TGCAACTTGTCTTAA	TGCAACTTGTCTTAA	3	1
ACTTTCAATGCGGAA	ACTTTCAATGCGGAA	13	1
TATATCAATGTATGA	TATATCAATGTATGA	3	1
AGGTTATGATTGCTA	AGGTTATGATTGCTA	1	1
GTGCAGGCACACGCG	GTGCAGGCACACGCG	1	1
GGAAAGTCTGGTTTC	GGAAAGTCTGGTTTC	1	1
CACTTGACAACTCTA	CACTTGACAACTCTA	1	1
TAATTTCCTGTATCC	TAATTTCCTGTATCC	1	1
AAAGAATTCACCTCA	AAAGAATTCACCTCA	1	1
ATTGACTAAATGTTT	ATTGACTAAATGTTT	2	1
ATGTGTGCTCCAGAA	ATGTGTGCTCCAGAA	2	1
CCTTGTCTACTAGTA	CCTTGTCTACTAGTA	1	1
GTTTTGCGTCGTGGG	GTTTTGCGTCGTGGG	1	1
AACGCTGTTATATCA	AACGCTGTTATATCA	7	1
AGCTCATATGTATAA	AGCTCATATGTATAA	2	1
GAATTCAGGGCCTAT	GAATTCAGGGCCTAT	1	1
AGGTTCCGTTAACCA	AGGTTCCGTTAACCA	2	1
ATCGGCCATTGTTGA	ATCGGCCATTGTTGA	1	1
ACTTTCGCAGTCTTG	ACTTTCGCAGTCTTG	1	1
CTTTTAAGTGTCGTG	CTTTTAAGTGTCGTG	1	1
TTAATGCGTGTAGAC	TTAATGCGTGTAGAC	1	1
TTAGAGTTGGATAGG	TTAGAGTTGGATAGG	1	1
AAGCAACTTATTTAA	AAGCAACTTATTTAA	2	1
TCATATATTTGTGGA	TCATATATTTGTGGA	3	1
AGATGTAGCGTTCAA	AGATGTAGCGTTCAA	4	1
TAAATATTTTGGGTC	TAAATATTTTGGGTC	1	1
ATTACACTATCTCAT	ATTACACTATCTCAT	1	1
TGGCGCTGGTTTGAC	TGGCGCTGGTTTGAC	1	1
GCTAGGCTTTAAGTT	GCTAGGCTTTAAGTT	3	1
GTGGGTAGGAGGGTG	GTGGGTAGGAGGGTG	7	1
GTTATCGTTACTGTC	GTTATCGTTACTGTC	1	1
CAAAATCCATCACTT	CAAAATCCATCACTT	2	1
GAGGTTCTGCTCTTG	GAGGTTCTGCTCTTG	3	1
TGTACGCAAACGTCA	TGTACGCAAACGTCA	1	1
CCAATCACTATAAAT	CCAATCACTATAAAT	5	1
GACTTCAAGGGGGTG	GACTTCAAGGGGGTG	9	1
ACTCTATTTTTAACT	ACTCTATTTTTAACT	1	1
ACAAACGTGTGAGAA	ACAAACGTGTGAGAA	5	1
TCTGCATGATCAGAT	TCTGCATGATCAGAT	4	1
ACTAATTTTGCAAAT	ACTAATTTTGCAAAT	5	1
CAGAGCTATATGTCC	CAGAGCTATATGTCC	3	1
TGTTTGAATATGGTG	TGTTTGAATATGGTG	1	1
TAGTTTAATAGTTTG	TAGTTTAATAGTTTG	6	1
TAGTGAGTAGGGGTG	TAGTGAGTAGGGGTG	2	1
CCAAGAAGTATTTTA	CCAAGAAGTATTTTA	1	1
TATTTCATTACTCGT	TATTTCATTACTCGT	7	1
ATTACCAAATCCAAT	ATTACCAAATCCAAT	2	1
ATTTATATCAGCTTG	ATTTATATCAGCTTG	1	1
TCGGGCGGAGAAAAG	TCGGGCGGAGAAAAG	1	1
ATAACGAGAATGACC	ATAACGAGAATGACC	5	1
AACGAGGGGCGTGCA	AACGAGGGGCGTGCA	1	1
ATAGAATGAATCTCG	ATAGAATGAATCTCG	2	1
AACTGTCGCGCGTTA	AACTGTCGCGCGTTA	1	1
CATTAAGGTTTCCTC	CATTAAGGTTTCCTC	2	1
CTAGAGGATGCGCAT	CTAGAGGATGCGCAT	21	1
GCGGGGCTTACCCGT	GCGGGGCTTACCCGT	3	1
AAACCGCAGTTTCAA	AAACCGCAGTTTCAA	4	1
GTCTTATTCTTACTG	GTCTTATTCTTACTG	6	1
ACTTAGTGTGTATAC	ACTTAGTGTGTATAC	6	1
CCGCACAATAAATTC	CCGCACAATAAATTC	7	1
TTTGAGGGGGGGCCG	TTTGAGGGGGGGCCG	5	1
TTCCTTCCCATATTG	TTCCTTCCCATATTG	1	1
ACAGTTAAACTCTAT	ACAGTTAAACTCTAT	3	1
GATTACTTCAGTATA	GATTACTTCAGTATA	10	1
TGAGCGATAGATAAT	TGAGCGATAGATAAT	1	1
AGTCATATGCACGTT	AGTCATATGCACGTT	1	1
TGGTCGGACGCGATT	TGGTCGGACGCGATT	2	1
TGTGAGAGTTCGACC	TGTGAGAGTTCGACC	2	1
TTTAAGGAGATCCGG	TTTAAGGAGATCCGG	2	1
ATTTTCACCCTGGCG	ATTTTCACCCTGGCG	1	1
TGGCTACGTATAAAC	TGGCTACGTATAAAC	2	1
TATCCTTATATCTCG	TATCCTTATATCTCG	2	1
TTTCCTGTTACTCCT	TTTCCTGTTACTCCT	3	1
CTTTCACTCATGACT	CTTTCACTCATGACT	12	1
CATATGGGTATCCTA	CATATGGGTATCCTA	1	1
GGGGCTGCGGCACGG	GGGGCTGCGGCACGG	1	1
TTGTCCTGGGTTACT	TTGTCCTGGGTTACT	2	1
TGTGTCTGTTGACAT	TGTGTCTGTTGACAT	2	1
ATTGTATCTCGGTTC	ATTGTATCTCGGTTC	6	1
TTAATGTATCAAACT	TTAATGTATCAAACT	1	1
CTCGGAAGCTACAAT	CTCGGAAGCTACAAT	3	1
AAGTTATGCGTGCTT	AAGTTATGCGTGCTT	2	1
TTTGTTAGCAAGATT	TTTGTTAGCAAGATT	2	1
ATATACGCGGGGGTG	ATATACGCGGGGGTG	1	1
GAATGGCTAGGGTGA	GAATGGCTAGGGTGA	2	1
GGTCGTTTCGGAGGG	GGTCGTTTCGGAGGG	44	1
TCATCCCGCGCACAC	TCATCCCGCGCACAC	68	1
GTATAAATTAAATTA	GTATAAATTAAATTA	3	1
CATAACCGCTTGCTT	CATAACCGCTTGCTT	2	1
TCTCTGAGAATTTAT	TCTCTGAGAATTTAT	1	1
CGCTACTACACACGT	CGCTACTACACACGT	3	1
GCGGTCAATCAGATT	GCGGTCAATCAGATT	3	1
TTTATTTCATTGACG	TTTATTTCATTGACG	1	1
TCTTCGTATGAGTAT	TCTTCGTATGAGTAT	4	1
GTGTGGCGCGGGGGG	GTGTGGCGCGGGGGG	1	1
GACATTATACTATAA	GACATTATACTATAA	2	1
TGTCCCTAAAAGTCA	TGTCCCTAAAAGTCA	12	1
TTCAGCCCTATCTTT	TTCAGCCCTATCTTT	6	1
TAATGTGATGTTTTC	TAATGTGATGTTTTC	1	1
GCCCATTACTAGGCG	GCCCATTACTAGGCG	1	1
TATAGCCAATGATTG	TATAGCCAATGATTG	1	1
TCCCGGATACGATTG	TCCCGGATACGATTG	18	1
CCCCTTCTGTCAATA	CCCCTTCTGTCAATA	3	1
TTGGTATGAAAATCT	TTGGTATGAAAATCT	6	1
AATACCGGTGACGGT	AATACCGGTGACGGT	1	1
CATCACGATATTGGA	CATCACGATATTGGA	2	1
AATGGATATAAACGA	AATGGATATAAACGA	2	1
ACAAACTTACCATTC	ACAAACTTACCATTC	4	1
AAACTAAATGCATTA	AAACTAAATGCATTA	2	1
TGTACGTATCAAAAA	TGTACGTATCAAAAA	1	1
AGTAAGCGTCTTTAC	AGTAAGCGTCTTTAC	1	1
CACGATGCTTTCTCT	CACGATGCTTTCTCT	3	1
GCAGGTTTTCGTAGT	GCAGGTTTTCGTAGT	7	1
TTTTAATACGTGAAT	TTTTAATACGTGAAT	1	1
ATTACTTCGATACTC	ATTACTTCGATACTC	11	1
GAAGAATACAGTGAT	GAAGAATACAGTGAT	1	1
TTCATGGGCTTCGTC	TTCATGGGCTTCGTC	3	1
TAAAATGGGACGGTC	TAAAATGGGACGGTC	2	1
GCTATTCGGTCCGGT	GCTATTCGGTCCGGT	4	1
TTGGGGACGTAACTG	TTGGGGACGTAACTG	3	1
TGTGTTGGAAAATTA	TGTGTTGGAAAATTA	26	1
CGTTCAAGTTACTCT	CGTTCAAGTTACTCT	22	1
AACGAGTCGAATAGT	AACGAGTCGAATAGT	49	1
AAAACTGGCTTACTA	AAAACTGGCTTACTA	2	1
TATACGTACGAGAGT	TATACGTACGAGAGT	3	1
GTTTTTCTACTGCTC	GTTTTTCTACTGCTC	3	1
ATGGCTGTCTCGGGT	ATGGCTGTCTCGGGT	2	1
AGGATGTGGGTTAAT	AGGATGTGGGTTAAT	5	1
AGAGTAGTGGGGATA	AGAGTAGTGGGGATA	2	1
CAGAGCTAACCCATG	CAGAGCTAACCCATG	3	1
TTATAGTACAGTTCC	TTATAGTACAGTTCC	13	1
CCTTTAGTACTTTTT	CCTTTAGTACTTTTT	1	1
TACTACCTCGCGTAT	TACTACCTCGCGTAT	1	1
TATCCTTATTTTCCT	TATCCTTATTTTCCT	1	1
ATGCACCTGTTTACA	ATGCACCTGTTTACA	1	1
AATCATTCCTTATTA	AATCATTCCTTATTA	2	1
CGAACTGTCTCAGAC	CGAACTGTCTCAGAC	4	1
CACCAGATAAACCCC	CACCAGATAAACCCC	1	1
AAATGGTTCCGCACT	AAATGGTTCCGCACT	3	1
TGGCGTAGTGGCCGG	TGGCGTAGTGGCCGG	61	1
GTTTCGAGATCGGGA	GTTTCGAGATCGGGA	4	1
GAGAGAGCTTTTCGC	GAGAGAGCTTTTCGC	5	1
CTATTACTTGCGACA	CTATTACTTGCGACA	5	1
TTTTGATACATCCTG	TTTTGATACATCCTG	2	1
GATGTCAGATTCACG	GATGTCAGATTCACG	2	1
CAGGAGGCATGTGGG	CAGGAGGCATGTGGG	1	1
AAGAGCTGGTATGAC	AAGAGCTGGTATGAC	2	1
CATAGTCGGTATAAT	CATAGTCGGTATAAT	2	1
GACAGCCTTCAGTAT	GACAGCCTTCAGTAT	4	1
GAAATGGGTGGCTTC	GAAATGGGTGGCTTC	1	1
ATTGATCTTTTCGGT	ATTGATCTTTTCGGT	3	1
GTTTAACGTTTTGGT	GTTTAACGTTTTGGT	1	1
GTCTGAAGCACGAGT	GTCTGAAGCACGAGT	3	1
ACTCGGTAGGTATTG	ACTCGGTAGGTATTG	4	1
CACAGTAGGTCTTCG	CACAGTAGGTCTTCG	4	1
TGGGATTGTTAAAGT	TGGGATTGTTAAAGT	5	1
GAGACAGGGTAGGTG	GAGACAGGGTAGGTG	5	1
TTCTTATTATTCACA	TTCTTATTATTCACA	1	1
AGAGGGGCTGCGTGG	AGAGGGGCTGCGTGG	13	1
TCTAAATTTTGCTTT	TCTAAATTTTGCTTT	1	1
ATTATAATTGTAATT	ATTATAATTGTAATT	3	1
TGAACGTATACTCAT	TGAACGTATACTCAT	1	1
GGACCACTACTGATG	GGACCACTACTGATG	5	1
TATTTTGAGTATGGA	TATTTTGAGTATGGA	1	1
GGCTTCTAGTTTGAG	GGCTTCTAGTTTGAG	1	1
GAGGGTTGGTATTCA	GAGGGTTGGTATTCA	1	1
GATGTCTGCATTTTT	GATGTCTGCATTTTT	3	1
TAATTCGTTTCGCAA	TAATTCGTTTCGCAA	2	1
TCGTATACGAAAACA	TCGTATACGAAAACA	1	1
GAAAGCGGTTTCACT	GAAAGCGGTTTCACT	1	1
TTATAACTATATGTT	TTATAACTATATGTT	2	1
CTTTAACGGTTCATA	CTTTAACGGTTCATA	4	1
TTACGAATATTTCAT	TTACGAATATTTCAT	48	1
CCCCGTTAATGTATT	CCCCGTTAATGTATT	36	1
TGTTTAAGCTGGTCG	TGTTTAAGCTGGTCG	1	1
TTCAAACCAGCGTCG	TTCAAACCAGCGTCG	19	1
CAATGAATCGTTTGG	CAATGAATCGTTTGG	3	1
TTAATAGGAATCCAC	TTAATAGGAATCCAC	3	1
CAATGTCAGTAATTT	CAATGTCAGTAATTT	2	1
ACAATACTTCCGACG	ACAATACTTCCGACG	4	1
ATAATTGTGTATTAA	ATAATTGTGTATTAA	4	1
AGTGTTCTTACGCTT	AGTGTTCTTACGCTT	2	1
TCCTCGAAGCTTTTA	TCCTCGAAGCTTTTA	2	1
TCTGCAATTTTGAAA	TCTGCAATTTTGAAA	2	1
AAACCCTGTTTAACC	AAACCCTGTTTAACC	1	1
AGGCTTCAGTTGGTT	AGGCTTCAGTTGGTT	1	1
GGGTGCGACTAGTAA	GGGTGCGACTAGTAA	2	1
GGAGTGTTGATTCAT	GGAGTGTTGATTCAT	7	1
TTTAAGCCTTCGTTA	TTTAAGCCTTCGTTA	2	1
GAAGGTAACGCGTAT	GAAGGTAACGCGTAT	3	1
TCTGCTCTGTTCCTT	TCTGCTCTGTTCCTT	1	1
ATTTGGTTATGCTGA	ATTTGGTTATGCTGA	2	1
TTCAGATCTAAAACA	TTCAGATCTAAAACA	1	1
GGGATCGTATGGTTG	GGGATCGTATGGTTG	3	1
TCCTTAAGCATCGAA	TCCTTAAGCATCGAA	3	1
CGGCTATAGATAGAC	CGGCTATAGATAGAC	2	1
TGCCTACTACTCCGG	TGCCTACTACTCCGG	7	1
CTTGTGTTATTCATT	CTTGTGTTATTCATT	1	1
TGTTTCGCTGCTACG	TGTTTCGCTGCTACG	2	1
AGTTCTATAAACCCA	AGTTCTATAAACCCA	4	1
TAGGTTGAATCATTT	TAGGTTGAATCATTT	1	1
TTAATCAGATCCACG	TTAATCAGATCCACG	30	1
TTCTTCATTTAAGTT	TTCTTCATTTAAGTT	1	1
ATTCGCATCAGTTAG	ATTCGCATCAGTTAG	2	1
CCTGGCTAACTTTCT	CCTGGCTAACTTTCT	2	1
AGTCATGCCTGGATT	AGTCATGCCTGGATT	4	1
TTAATACATTTCATG	TTAATACATTTCATG	1	1
CTACCCACATCCTTG	CTACCCACATCCTTG	7	1
TATTTATGGGAACAC	TATTTATGGGAACAC	2	1
ATCATAGTAGTCGTA	ATCATAGTAGTCGTA	1	1
TAAGGAACTGTATCT	TAAGGAACTGTATCT	2	1
ATTTATAGGATTCTC	ATTTATAGGATTCTC	2	1
AAACATACCTAAACA	AAACATACCTAAACA	3	1
CTGAGTGTCGTGTTG	CTGAGTGTCGTGTTG	2	1
TTCCAATCGGGGGGT	TTCCAATCGGGGGGT	4	1
CCAACTATCGGTTCT	CCAACTATCGGTTCT	6	1
TCATTTCCGTCTATG	TCATTTCCGTCTATG	1	1
TTTGGTCTACTTTTT	TTTGGTCTACTTTTT	2	1
AGAGTATGTTACATT	AGAGTATGTTACATT	4	1
ATGAGGGTTCTACAT	ATGAGGGTTCTACAT	1	1
ACCGTTTAGCCAAAT	ACCGTTTAGCCAAAT	2	1
AGAGCTTGAGGACTA	AGAGCTTGAGGACTA	2	1
GCGTAAGACGAGATC	GCGTAAGACGAGATC	3	1
TTGCGATTAAGATTA	TTGCGATTAAGATTA	1	1
TCATTTACCCTATTA	TCATTTACCCTATTA	2	1
CTTAAGGCCGGAGTT	CTTAAGGCCGGAGTT	1	1
TAACATTCGATATAG	TAACATTCGATATAG	2	1
GAATTCGGTTTGGGC	GAATTCGGTTTGGGC	1	1
ATCTGGAAGCCGGAT	ATCTGGAAGCCGGAT	2	1
CATGGGTGTGTTATA	CATGGGTGTGTTATA	2	1
GGTGGGCACATTCAC	GGTGGGCACATTCAC	1	1
GGACGTCGTTATAAT	GGACGTCGTTATAAT	1	1
TTACACATCTCTGTC	TTACACATCTCTGTC	1	1
ATTGTTGATGCGAGG	ATTGTTGATGCGAGG	5	1
TATTTGACTTTTAAT	TATTTGACTTTTAAT	1	1
CTATGACGCATTCAA	CTATGACGCATTCAA	4	1
TTGGAACGATCTGCT	TTGGAACGATCTGCT	3	1
AATGTCTCCGCTTTA	AATGTCTCCGCTTTA	6	1
TGCACTGCTGATATA	TGCACTGCTGATATA	2	1
TGCGTTCCTAACGTT	TGCGTTCCTAACGTT	1	1
GAAGAAAACGTCATT	GAAGAAAACGTCATT	3	1
CGATAGTCACAGAGG	CGATAGTCACAGAGG	8	1
TTCTATCTCTCAGGG	TTCTATCTCTCAGGG	2	1
GCTATGTTATTTGTA	GCTATGTTATTTGTA	1	1
GGTGCCTTACTAAGC	GGTGCCTTACTAAGC	1	1
GGAGTCGCTAAATCA	GGAGTCGCTAAATCA	2	1
GTGGTGACGTGGCGA	GTGGTGACGTGGCGA	3	1
AGTCCAGAGACTGGA	AGTCCAGAGACTGGA	59	1
TCGGTTTAACTCCCA	TCGGTTTAACTCCCA	3	1
GTCATTTTAATTGTA	GTCATTTTAATTGTA	1	1
AGATTAACGTAACTG	AGATTAACGTAACTG	2	1
CTACATTATAAGTTT	CTACATTATAAGTTT	2	1
AAAGTTAAATGTTTT	AAAGTTAAATGTTTT	3	1
ATTTATGTCGTAAAA	ATTTATGTCGTAAAA	3	1
GTTGACAAACGGTCA	GTTGACAAACGGTCA	1	1
TATAATGTTTATGCT	TATAATGTTTATGCT	2	1
GTCGCAGGCGACAGG	GTCGCAGGCGACAGG	1	1
CTTTTCAGGTTGCCA	CTTTTCAGGTTGCCA	1	1
CCCTACTAGTCTACC	CCCTACTAGTCTACC	6	1
TTAGGGTTGGTTCTC	TTAGGGTTGGTTCTC	28	1
TTTGTCAAGGAGGAG	TTTGTCAAGGAGGAG	3	1
TGGATCACATAACCC	TGGATCACATAACCC	3	1
GGTAAAGGGATGTAG	GGTAAAGGGATGTAG	1	1
TTGTTCGTATTCGGT	TTGTTCGTATTCGGT	3	1
GCATCCGCAGGTCTG	GCATCCGCAGGTCTG	1	1
CTACAGGGCTCTTAG	CTACAGGGCTCTTAG	32	1
ATCAAAACCAATCTT	ATCAAAACCAATCTT	7	1
GAGAGATGTATTGGC	GAGAGATGTATTGGC	2	1
CTATGGGCAAGTCTG	CTATGGGCAAGTCTG	5	1
GGAGTTGAGCTATGA	GGAGTTGAGCTATGA	1	1
CTCCATAAAGGTCTT	CTCCATAAAGGTCTT	1	1
TGGGTGTGGCGATGT	TGGGTGTGGCGATGT	1	1
TACTCATCATATTTC	TACTCATCATATTTC	1	1
CTTGATACTTATTGT	CTTGATACTTATTGT	1	1
AGTAAGACGTCCACT	AGTAAGACGTCCACT	1	1
ACTTTAGTTTCACTG	ACTTTAGTTTCACTG	1	1
CAAAGCGGGGACGTG	CAAAGCGGGGACGTG	1	1
ATAAACTGTAGAGTC	ATAAACTGTAGAGTC	3	1
TAATTTTACAGGTTG	TAATTTTACAGGTTG	5	1
GTACAGTGATGGTCA	GTACAGTGATGGTCA	1	1
TATGCAGGTAATTAA	TATGCAGGTAATTAA	3	1
GCTTACTTCAGATAA	GCTTACTTCAGATAA	2	1
TGAGCTCGTTACAAT	TGAGCTCGTTACAAT	2	1
TTTCTGTCCTCTTTT	TTTCTGTCCTCTTTT	1	1
TTTGGACTGATGCTT	TTTGGACTGATGCTT	1	1
AGTTTTGTTTATGTA	AGTTTTGTTTATGTA	1	1
GTGGCAGATGGCCTG	GTGGCAGATGGCCTG	1	1
CATTCTCTAATCCCA	CATTCTCTAATCCCA	1	1
ATCGTGGAGCCATCA	ATCGTGGAGCCATCA	3	1
TCTATTTAGTTTGTT	TCTATTTAGTTTGTT	1	1
GTCGGTTTAACAACT	GTCGGTTTAACAACT	6	1
GAATCTAATATCAAT	GAATCTAATATCAAT	2	1
AAAAAGTTAGCAATA	AAAAAGTTAGCAATA	6	1
AATCACTTGGTAAAA	AATCACTTGGTAAAA	1	1
TGCTTAGAATGTGTG	TGCTTAGAATGTGTG	1	1
TGATGCTAGGGATCA	TGATGCTAGGGATCA	1	1
CGCGTCTGGTAGTAG	CGCGTCTGGTAGTAG	4	1
AAACCCTGTTTGCGA	AAACCCTGTTTGCGA	1	1
TTCTGGTTCACATTT	TTCTGGTTCACATTT	1	1
CATTTTTTCTATGTT	CATTTTTTCTATGTT	1	1
TTTTCAAATATATAT	TTTTCAAATATATAT	1	1
CGCTTTATATAGCAT	CGCTTTATATAGCAT	1	1
TGTGGCAGATCACGT	TGTGGCAGATCACGT	20	1
ATCGGGGTCCATCGT	ATCGGGGTCCATCGT	1	1
ACGTTCGAGTCTGTA	ACGTTCGAGTCTGTA	1	1
CCCCACTTAAATCGA	CCCCACTTAAATCGA	1	1
ACGAAGTTATGTTCA	ACGAAGTTATGTTCA	1	1
CGACTAGAACTAATT	CGACTAGAACTAATT	1	1
TAGCTCATCAGCGCT	TAGCTCATCAGCGCT	4	1
TGTTGAACCCGGCTT	TGTTGAACCCGGCTT	1	1
TTGAAATGTTTGCTC	TTGAAATGTTTGCTC	1	1
ATGAGAGTATTGAAC	ATGAGAGTATTGAAC	3	1
GGGAGAGAGTAAGGG	GGGAGAGAGTAAGGG	2	1
ATTCGTGTATTTTCT	ATTCGTGTATTTTCT	1	1
GATTATTGTCATCTA	GATTATTGTCATCTA	3	1
GGTAGGGGGAGTGGT	GGTAGGGGGAGTGGT	6	1
TGAGCCGGGAATTCG	TGAGCCGGGAATTCG	4	1
GTTTCGTTCAATTGA	GTTTCGTTCAATTGA	1	1
GGTCTGGTATGGACG	GGTCTGGTATGGACG	1	1
CCCGTGTTCGATGTT	CCCGTGTTCGATGTT	4	1
TTGAAAAAACATAAA	TTGAAAAAACATAAA	1	1
TCGAAGCATGTCAAG	TCGAAGCATGTCAAG	1	1
TAATACGATTATAAT	TAATACGATTATAAT	2	1
TTCGTTAAATCATAG	TTCGTTAAATCATAG	2	1
GGATTTCACCTTTAT	GGATTTCACCTTTAT	3	1
ATCGTCACACGGATA	ATCGTCACACGGATA	1	1
GGACTGTGATTGTGG	GGACTGTGATTGTGG	3	1
AATGACTCCTCATTT	AATGACTCCTCATTT	2	1
CTTGTTGCAGTGGTC	CTTGTTGCAGTGGTC	12	1
GCCTCAACTCCTTGA	GCCTCAACTCCTTGA	8	1
TATCCGATCTAAATA	TATCCGATCTAAATA	6	1
CTGTACGTGGCGCCA	CTGTACGTGGCGCCA	1	1
TCTGGTCGTTCGTCT	TCTGGTCGTTCGTCT	1	1
AACAGTGCGGGACTT	AACAGTGCGGGACTT	2	1
ACCATTTCGGTCTTT	ACCATTTCGGTCTTT	1	1
TGAGGGTAATTTGAA	TGAGGGTAATTTGAA	1	1
TGTCCAACTTCCTTC	TGTCCAACTTCCTTC	1	1
ACGCCTCTCAGATAA	ACGCCTCTCAGATAA	5	1
GCTTCGATACGGCGT	GCTTCGATACGGCGT	15	1
TTGTCTTCGTCGTTT	TTGTCTTCGTCGTTT	2	1
TTACGGTCTCATACG	TTACGGTCTCATACG	1	1
AGTGATTAGATTAGT	AGTGATTAGATTAGT	1	1
ATCTCACTTCGACTT	ATCTCACTTCGACTT	1	1
AGATGCGAGTTAAAA	AGATGCGAGTTAAAA	5	1
GAGCATGCTGATGCT	GAGCATGCTGATGCT	2	1
CTCACAAACCTCGTA	CTCACAAACCTCGTA	3	1
TCATTATATCGTTAT	TCATTATATCGTTAT	1	1
TGCGCAAAGTGGGTG	TGCGCAAAGTGGGTG	2	1
TAATTTTTTAACGCA	TAATTTTTTAACGCA	6	1
TTACGCGGGTTGGTT	TTACGCGGGTTGGTT	4	1
TTTGGATGTAGCCAT	TTTGGATGTAGCCAT	2	1
GGAAAACTACCTGTG	GGAAAACTACCTGTG	2	1
TGCGTTGAGTAGGGG	TGCGTTGAGTAGGGG	5	1
GATACGTACTACCCG	GATACGTACTACCCG	4	1
GTATTTATCCATAAT	GTATTTATCCATAAT	3	1
TTTCTAACACTGTTT	TTTCTAACACTGTTT	8	1
TTCATCCGTAATATG	TTCATCCGTAATATG	4	1
TAACGGGTTATTGTT	TAACGGGTTATTGTT	5	1
CTGTTAATGATGCGT	CTGTTAATGATGCGT	2	1
CCTGCTATCCATGAA	CCTGCTATCCATGAA	2	1
GAGTTAGCTGTTGCT	GAGTTAGCTGTTGCT	3	1
CTAGGCTGATTCCAA	CTAGGCTGATTCCAA	3	1
AGGTACACCCTTCTG	AGGTACACCCTTCTG	3	1
GACGTGGAGGGGCGT	GACGTGGAGGGGCGT	2	1
TACCAAAGAGGTATT	TACCAAAGAGGTATT	4	1
TTACATATGGTATTA	TTACATATGGTATTA	1	1
TTCGCCTAATGTTGT	TTCGCCTAATGTTGT	1	1
CCAATGACTTCGAGG	CCAATGACTTCGAGG	2	1
TAATTCGGTTAGCCT	TAATTCGGTTAGCCT	3	1
TACATCGTCCTAGCG	TACATCGTCCTAGCG	1	1
AGTCCAGAGACTTGA	AGTCCAGAGACTTGA	1	1
TCATATGGTCATACT	TCATATGGTCATACT	1	1
ATTTTGGGTGGGGTA	ATTTTGGGTGGGGTA	3	1
GCATCAGACCTTTTA	GCATCAGACCTTTTA	2	1
CGAGATCGTTTATTG	CGAGATCGTTTATTG	1	1
AGAGCGGTGGGGGTG	AGAGCGGTGGGGGTG	4	1
GGCATTGTAGAGGAG	GGCATTGTAGAGGAG	5	1
TCTAGTGCGTATTCC	TCTAGTGCGTATTCC	10	1
TGTACAGTGAGCTCG	TGTACAGTGAGCTCG	3	1
TCACGAATAATTAGT	TCACGAATAATTAGT	1	1
CAAGAGGATTAGTTA	CAAGAGGATTAGTTA	2	1
AAAACTGGTTAGGAT	AAAACTGGTTAGGAT	2	1
TTAGTAAAGATCTTT	TTAGTAAAGATCTTT	2	1
ATCTCACTCTATACG	ATCTCACTCTATACG	1	1
TTCTATTTTAACATT	TTCTATTTTAACATT	1	1
AGATGCACAGTGGAC	AGATGCACAGTGGAC	1	1
CGCGTGGGGGCACCC	CGCGTGGGGGCACCC	4	1
AGTTTTAGGTCTCTT	AGTTTTAGGTCTCTT	1	1
GCGGCGTTTTGAGGG	GCGGCGTTTTGAGGG	16	1
AGGTCGTGACTTATT	AGGTCGTGACTTATT	2	1
ATAGAGCCTTGTTCA	ATAGAGCCTTGTTCA	3	1
CTCAAAAACTACGAA	CTCAAAAACTACGAA	10	1
ATATCACCAAAACAT	ATATCACCAAAACAT	4	1
AGTCAAGCACTAAGT	AGTCAAGCACTAAGT	4	1
ACTAAGAGATATTAT	ACTAAGAGATATTAT	2	1
GCCTTTGATCTAGTT	GCCTTTGATCTAGTT	1	1
CGTCGTTGCGTGGAA	CGTCGTTGCGTGGAA	1	1
CCTTGGGGTGCCTTA	CCTTGGGGTGCCTTA	2	1
ACGCTTATAAAGTAC	ACGCTTATAAAGTAC	2	1
ACATGTCATGATTTC	ACATGTCATGATTTC	2	1
TTAACCATAATGGCT	TTAACCATAATGGCT	1	1
GCGGTGCGGGGGCGG	GCGGTGCGGGGGCGG	2	1
TCTGTGTGTAGCTCA	TCTGTGTGTAGCTCA	2	1
TCAGTGTCTATTGAT	TCAGTGTCTATTGAT	2	1
TGGTGGTAATTTCGC	TGGTGGTAATTTCGC	6	1
TGTTAGAGGGAATTA	TGTTAGAGGGAATTA	3	1
TTGATTAACCACTCG	TTGATTAACCACTCG	1	1
GCCAGGGATCGTTAT	GCCAGGGATCGTTAT	5	1
TCACCTAGAAATGGT	TCACCTAGAAATGGT	1	1
ATATTTATGGTTGTC	ATATTTATGGTTGTC	8	1
AATGTGTCATTGTAT	AATGTGTCATTGTAT	4	1
TAGGCATTGGTGGAG	TAGGCATTGGTGGAG	6	1
AGAGGGGGTGGAGAA	AGAGGGGGTGGAGAA	3	1
ATTGTGGGTTCTGGT	ATTGTGGGTTCTGGT	1	1
TGTACTTGGATGTGG	TGTACTTGGATGTGG	2	1
AGAAGTTTGTAGGGA	AGAAGTTTGTAGGGA	1	1
GACAAGGTCTAAGTA	GACAAGGTCTAAGTA	3	1
TCGGTCGTCCTGCTT	TCGGTCGTCCTGCTT	2	1
ATATATGTTCCGAAT	ATATATGTTCCGAAT	1	1
TATCGAACGTTCACA	TATCGAACGTTCACA	3	1
CTTTTACGTGCATCT	CTTTTACGTGCATCT	1	1
GGATAGATACCATAT	GGATAGATACCATAT	1	1
AGGATCCTCAAAAAA	AGGATCCTCAAAAAA	1	1
ACGGTAATCAGGCAT	ACGGTAATCAGGCAT	5	1
GAAACGGTGCCAATG	GAAACGGTGCCAATG	2	1
GGAAGTGCTTTTAAG	GGAAGTGCTTTTAAG	1	1
TCAATTCAATTGCTG	TCAATTCAATTGCTG	1	1
AAAACGGGGGGTACT	AAAACGGGGGGTACT	1	1
TTGCAGAGACACATG	TTGCAGAGACACATG	2	1
GAACACAATCCCTTT	GAACACAATCCCTTT	1	1
GAGCGTTGATCACTA	GAGCGTTGATCACTA	2	1
CACCTTGATGTTAGG	CACCTTGATGTTAGG	3	1
CGAAGCTGTTCTTCA	CGAAGCTGTTCTTCA	1	1
AACTTTAGTTTTCTC	AACTTTAGTTTTCTC	1	1
GGGTCACTATATTGG	GGGTCACTATATTGG	1	1
GGACTTAAGCTAGCG	GGACTTAAGCTAGCG	3	1
GCGGTATCCCGTGTC	GCGGTATCCCGTGTC	2	1
CATGAATGTATTTGG	CATGAATGTATTTGG	1	1
TCCCTATGAATCTTT	TCCCTATGAATCTTT	3	1
AACAGTGAAAATTAT	AACAGTGAAAATTAT	2	1
ATACATACAATTATA	ATACATACAATTATA	1	1
GCTACACTCACATAT	GCTACACTCACATAT	2	1
GTACTCGAAGAGTTT	GTACTCGAAGAGTTT	1	1
CTCTCCCAAGACATA	CTCTCCCAAGACATA	3	1
TTCGGAATTGACGAT	TTCGGAATTGACGAT	5	1
TGTCTACCTAGAATC	TGTCTACCTAGAATC	2	1
GAATTCCATTGACTT	GAATTCCATTGACTT	2	1
AACAACATTTAGTCA	AACAACATTTAGTCA	1	1
TATACTTCTTAAAGA	TATACTTCTTAAAGA	1	1
AAATTGCCAATTGAC	AAATTGCCAATTGAC	5	1
CCTCTTTAATGTATG	CCTCTTTAATGTATG	1	1
CTATCTGATGTATAA	CTATCTGATGTATAA	2	1
TTAGTACACACATTG	TTAGTACACACATTG	1	1
CTCCCACTGTTCTTT	CTCCCACTGTTCTTT	3	1
CCAGCAAAGTATATG	CCAGCAAAGTATATG	4	1
AATCGATATCATTTA	AATCGATATCATTTA	1	1
CCAAGTCTACTCATA	CCAAGTCTACTCATA	1	1
ACATTGTAACGAAGG	ACATTGTAACGAAGG	1	1
AGGATTTTGTTTAGT	AGGATTTTGTTTAGT	3	1
CAACAACCACAACTC	CAACAACCACAACTC	2	1
GCAACACGAAGTGGA	GCAACACGAAGTGGA	3	1
CTTATCTCAATATTT	CTTATCTCAATATTT	2	1
TTACGCCCCCTTTTT	TTACGCCCCCTTTTT	3	1
TCAGACATTTTTGTT	TCAGACATTTTTGTT	3	1
GGCGCTAAATATCAT	GGCGCTAAATATCAT	1	1
TACAGGTTGCGACAT	TACAGGTTGCGACAT	19	1
TCCTTGCTTATAATG	TCCTTGCTTATAATG	2	1
TATCTACAGCGCGGA	TATCTACAGCGCGGA	4	1
GTGTGGCGGGGGGGG	GTGTGGCGGGGGGGG	1	1
ATACCGTGCCTGAAC	ATACCGTGCCTGAAC	1	1
ATCCAAGCTAACTTC	ATCCAAGCTAACTTC	3	1
CGTAACCGCTTCTAG	CGTAACCGCTTCTAG	4	1
TTCATCTGTTTCTTT	TTCATCTGTTTCTTT	40	1
GACCTAGAGGGTTCA	GACCTAGAGGGTTCA	1	1
AAACCTGATGCTGTC	AAACCTGATGCTGTC	2	1
AGCCTTTTTTAGGAT	AGCCTTTTTTAGGAT	3	1
ATGGCAATCTCCTAC	ATGGCAATCTCCTAC	1	1
TTATTGTATACCGTG	TTATTGTATACCGTG	3	1
CTTAAACCGCACAAT	CTTAAACCGCACAAT	1	1
TTCCAGGGGACAGGG	TTCCAGGGGACAGGG	13	1
ATTGAGGGGCGAATA	ATTGAGGGGCGAATA	6	1
GGTCACAGGTTTAGT	GGTCACAGGTTTAGT	3	1
CTTGTGACAGATGTA	CTTGTGACAGATGTA	1	1
CCATGGGGCTGGAGG	CCATGGGGCTGGAGG	38	1
TCTTAAGATCGGTCG	TCTTAAGATCGGTCG	1	1
AGTGGACGATTTGTG	AGTGGACGATTTGTG	2	1
ATACTAGTTAACATC	ATACTAGTTAACATC	1	1
TTTCTAAACATTGAC	TTTCTAAACATTGAC	2	1
TATAGATAAGTGTAA	TATAGATAAGTGTAA	1	1
GTTTATCATAGCACG	GTTTATCATAGCACG	1	1
ACAGATTCACCTGAC	ACAGATTCACCTGAC	1	1
ATTGGATAAGGATGT	ATTGGATAAGGATGT	4	1
TTTTTGTGCCCCGAG	TTTTTGTGCCCCGAG	25	1
GTTAGTGGTATGGTC	GTTAGTGGTATGGTC	1	1
CCACTAAACTCACTT	CCACTAAACTCACTT	2	1
CGGGGCCGTGGGATA	CGGGGCCGTGGGATA	1	1
ACGGCAGTTATCTGG	ACGGCAGTTATCTGG	4	1
CCATAGTCTCCGCTT	CCATAGTCTCCGCTT	14	1
ACTACGTTCGTATGC	ACTACGTTCGTATGC	2	1
TTTTGTACTTTACTT	TTTTGTACTTTACTT	4	1
TTCAAGGGCATATAT	TTCAAGGGCATATAT	3	1
CTTGTGGCAACTGTT	CTTGTGGCAACTGTT	8	1
AAAACAGCTCACTTC	AAAACAGCTCACTTC	1	1
ATTTGCTCTAGTCGT	ATTTGCTCTAGTCGT	1	1
TTAATACATCGGAAA	TTAATACATCGGAAA	4	1
CGTTACGGGGACTGT	CGTTACGGGGACTGT	2	1
AAGAACTATAGAATA	AAGAACTATAGAATA	1	1
TCATCCAAAAAGTAT	TCATCCAAAAAGTAT	2	1
GTACGACTGGGGCAG	GTACGACTGGGGCAG	5	1
AGACATGGTGGTAAA	AGACATGGTGGTAAA	1	1
AAACTCTCGGATGCG	AAACTCTCGGATGCG	3	1
TTTTTGATGTTCACT	TTTTTGATGTTCACT	1	1
AAGCTGGCCCTGCTA	AAGCTGGCCCTGCTA	1	1
GAAAACTCATCACTT	GAAAACTCATCACTT	2	1
CCCTCAAGTTTGTCT	CCCTCAAGTTTGTCT	1	1
AAAAGCGCCGAACAC	AAAAGCGCCGAACAC	1	1
CGCAACTAGCTAACC	CGCAACTAGCTAACC	4	1
GACAATCTAGCCATG	GACAATCTAGCCATG	8	1
TGACGTGGTATCGAA	TGACGTGGTATCGAA	1	1
GTAATGTTACTTGGA	GTAATGTTACTTGGA	3	1
TTTATGTTAACCGTT	TTTATGTTAACCGTT	8	1
TTGGCTGGCATCTAT	TTGGCTGGCATCTAT	1	1
TCTCTATGATCAGGT	TCTCTATGATCAGGT	3	1
TATACTTTCGTATGC	TATACTTTCGTATGC	1	1
CTGACCCTTAATCTA	CTGACCCTTAATCTA	1	1
ATGAATGAAGTGAAC	ATGAATGAAGTGAAC	2	1
TCCGTAGGGGGTCGA	TCCGTAGGGGGTCGA	2	1
CTATGACAGTCGTCA	CTATGACAGTCGTCA	1	1
GGTTGGGAATAAGTT	GGTTGGGAATAAGTT	4	1
CCATGCTCCGTATTT	CCATGCTCCGTATTT	1	1
GTCATTTACAAGATC	GTCATTTACAAGATC	1	1
GGCTCGCGGGAGGTG	GGCTCGCGGGAGGTG	1	1
AATCGATGGTTCTTT	AATCGATGGTTCTTT	3	1
TGAGTGCCGCGTAAT	TGAGTGCCGCGTAAT	2	1
GGATTGGAGCTGGCT	GGATTGGAGCTGGCT	2	1
GGTCGACTGGTTTCT	GGTCGACTGGTTTCT	1	1
CTATTCACGATCGGT	CTATTCACGATCGGT	3	1
ATACGATCTACAACT	ATACGATCTACAACT	2	1
TCCTAAGTTATCGTT	TCCTAAGTTATCGTT	5	1
GAGTACCTTGTTTTC	GAGTACCTTGTTTTC	1	1
GGGGGGTAGACGTCA	GGGGGGTAGACGTCA	2	1
CAAACAGTTCTTATA	CAAACAGTTCTTATA	3	1
GAATAATACTTATCG	GAATAATACTTATCG	3	1
CGGGAGAGTGGAAGC	CGGGAGAGTGGAAGC	1	1
AAACATATTCCAGGT	AAACATATTCCAGGT	1	1
CTAGGCCATCGTTTA	CTAGGCCATCGTTTA	2	1
GAAAGATTGCCAAGT	GAAAGATTGCCAAGT	3	1
AAATTGTATTTATGT	AAATTGTATTTATGT	3	1
AATCGGAGCCAGCAC	AATCGGAGCCAGCAC	4	1
TGCAGTCCTCAATTC	TGCAGTCCTCAATTC	1	1
GAACAGGTTTACACT	GAACAGGTTTACACT	2	1
AATAGTAATTATTTG	AATAGTAATTATTTG	3	1
CGACCACGTACAAAA	CGACCACGTACAAAA	1	1
TTTTCCTTAGTCTCT	TTTTCCTTAGTCTCT	16	1
GTATGATCATTCCAT	GTATGATCATTCCAT	4	1
TGTCAGAGCCATTAA	TGTCAGAGCCATTAA	3	1
CCACTTGGGTTCAGT	CCACTTGGGTTCAGT	2	1
AAACAACAAAACTTG	AAACAACAAAACTTG	1	1
AGCGGGAGACAGACA	AGCGGGAGACAGACA	2	1
AAATAGATTCTACGT	AAATAGATTCTACGT	1	1
TTACCATGCGGTAAA	TTACCATGCGGTAAA	1	1
TATCAGTAACAATGC	TATCAGTAACAATGC	3	1
TAAGCCGCGGATAGT	TAAGCCGCGGATAGT	5	1
TGGTGTTTTGCGTAC	TGGTGTTTTGCGTAC	1	1
AAATTTTCGTAATGA	AAATTTTCGTAATGA	1	1
TAACGAGGATCTTCA	TAACGAGGATCTTCA	4	1
CATTACCACTTGTCA	CATTACCACTTGTCA	1	1
TAACTCCTCTATCAT	TAACTCCTCTATCAT	4	1
TCATTCATTTACAGA	TCATTCATTTACAGA	3	1
TAAGGAGGTGGCGGG	TAAGGAGGTGGCGGG	1	1
ATATTGTTTCCACAG	ATATTGTTTCCACAG	1	1
TTTACAGACTTTTCG	TTTACAGACTTTTCG	3	1
CCCACAATCGATCTT	CCCACAATCGATCTT	1	1
CAGCCTAGGGGATGG	CAGCCTAGGGGATGG	4	1
ATCGCCTTAGGCAAT	ATCGCCTTAGGCAAT	1	1
GTAAGACAAACCAGA	GTAAGACAAACCAGA	7	1
TTTGTTTGAGTGGCT	TTTGTTTGAGTGGCT	5	1
ATTGGTGTATCTTAC	ATTGGTGTATCTTAC	1	1
ATTAAATGAATGCGT	ATTAAATGAATGCGT	1	1
ACCATAGGTTTTTCC	ACCATAGGTTTTTCC	2	1
TCCAATTTACGTTTA	TCCAATTTACGTTTA	1	1
CGGACTACTATCTGT	CGGACTACTATCTGT	2	1
TATACCTTGGATAAT	TATACCTTGGATAAT	3	1
GTCTTCCGATAATTT	GTCTTCCGATAATTT	2	1
GTATAGAATTCGTTC	GTATAGAATTCGTTC	3	1
GTGTTTTAGTAGTAA	GTGTTTTAGTAGTAA	2	1
TAGTAGGATGTTACT	TAGTAGGATGTTACT	2	1
TTTAATACAATTTGC	TTTAATACAATTTGC	3	1
TCTGCTGAGGTCGGC	TCTGCTGAGGTCGGC	1	1
GCCTTCTTTAGAGGA	GCCTTCTTTAGAGGA	1	1
TCAAGGCAAGTTCAT	TCAAGGCAAGTTCAT	2	1
ATATTGCACTCTCAT	ATATTGCACTCTCAT	2	1
TTCCTTTGTACAATG	TTCCTTTGTACAATG	1	1
TATCATGTCTGGGAT	TATCATGTCTGGGAT	2	1
GCTCAAAGTAACTAC	GCTCAAAGTAACTAC	3	1
GTTCTACGCATATTT	GTTCTACGCATATTT	1	1
GATTAGCATATTCAA	GATTAGCATATTCAA	1	1
TAAGGACGATTTGAT	TAAGGACGATTTGAT	1	1
GCAGCATCTATACGT	GCAGCATCTATACGT	1	1
CTCCTAGTGCTACAA	CTCCTAGTGCTACAA	4	1
TGAGGCAGCCATGTG	TGAGGCAGCCATGTG	1	1
TTTCATCGCCTCCTC	TTTCATCGCCTCCTC	1	1
ATCATTACAGTCTTT	ATCATTACAGTCTTT	1	1
GACGTGCTAAGTCGA	GACGTGCTAAGTCGA	2	1
AAGTTTGGGTGGCAG	AAGTTTGGGTGGCAG	2	1
ACTGGAAACCGCTAG	ACTGGAAACCGCTAG	5	1
GACGGTTAATCTGTC	GACGGTTAATCTGTC	3	1
TCGATAGGGCTTTGT	TCGATAGGGCTTTGT	2	1
ACCGGGAAGGTATTG	ACCGGGAAGGTATTG	3	1
TGATGCGGGCGAGCA	TGATGCGGGCGAGCA	1	1
GTATTGATAACAGGG	GTATTGATAACAGGG	1	1
AAGTGATCATTTACA	AAGTGATCATTTACA	4	1
TCGCTCGACACCTTT	TCGCTCGACACCTTT	3	1
TTATAAGTCAAGCGT	TTATAAGTCAAGCGT	1	1
CAAGCTGAATGAATA	CAAGCTGAATGAATA	1	1
TTGGCGCATGATTAA	TTGGCGCATGATTAA	3	1
TCATGAAAAGTCTTT	TCATGAAAAGTCTTT	4	1
CACACTCTATATGTA	CACACTCTATATGTA	1	1
CCATCAACATAATTA	CCATCAACATAATTA	1	1
GGGGGCGCGCGGCCG	GGGGGCGCGCGGCCG	2	1
GCGGAATGGTGTGTG	GCGGAATGGTGTGTG	8	1
GGTAAACAAAGTCGA	GGTAAACAAAGTCGA	1	1
TGATGCTCGTCTTAA	TGATGCTCGTCTTAA	2	1
TTATTGACCATTCGT	TTATTGACCATTCGT	1	1
TAGGGAGGGTGCGTG	TAGGGAGGGTGCGTG	9	1
CATTAGTCTCTTTGC	CATTAGTCTCTTTGC	3	1
TTAATAATCTATAGT	TTAATAATCTATAGT	1	1
GGGCGCATGGGCATA	GGGCGCATGGGCATA	30	1
GGCTTTAACTAGCGT	GGCTTTAACTAGCGT	1	1
GTGGGGTATGACAAA	GTGGGGTATGACAAA	2	1
GGCGGGGAGGGACGT	GGCGGGGAGGGACGT	1	1
ATGTTATCCCTATTT	ATGTTATCCCTATTT	1	1
TTATTGAAACATACA	TTATTGAAACATACA	2	1
CGAAGATTTTTGAGT	CGAAGATTTTTGAGT	1	1
ACTTATTTTAATCCT	ACTTATTTTAATCCT	4	1
AGTATGGCCAAATTA	AGTATGGCCAAATTA	2	1
AAGTACTTCGAAGCA	AAGTACTTCGAAGCA	3	1
GGTGGGTCGTGTGAG	GGTGGGTCGTGTGAG	2	1
TATCAAAACAACTTC	TATCAAAACAACTTC	1	1
TATAAGCGTTACGTG	TATAAGCGTTACGTG	3	1
GCCGTGTTGTACCAT	GCCGTGTTGTACCAT	7	1
AACATGACGTCTGTT	AACATGACGTCTGTT	1	1
TGGGGATGCGGGCCG	TGGGGATGCGGGCCG	2	1
CAAGTCGTTGATGGA	CAAGTCGTTGATGGA	4	1
TCTTCATAACATAAT	TCTTCATAACATAAT	1	1
GAGAAATTGTAGATG	GAGAAATTGTAGATG	2	1
TCAATCGGAGAGGAA	TCAATCGGAGAGGAA	4	1
CAAGTTTATCGGCTG	CAAGTTTATCGGCTG	2	1
GGCGATGATTTAACA	GGCGATGATTTAACA	4	1
TATATTGAGTGTGGT	TATATTGAGTGTGGT	1	1
GAAAGGGTCTCGAAT	GAAAGGGTCTCGAAT	1	1
ATGGGATGCTAACTT	ATGGGATGCTAACTT	1	1
GCATAGTGTCTGAAT	GCATAGTGTCTGAAT	1	1
CCGCCGAGATTTAAT	CCGCCGAGATTTAAT	1	1
CTTTGACCAGCCCCG	CTTTGACCAGCCCCG	2	1
GACAAGGTTATCCTT	GACAAGGTTATCCTT	3	1
ACAAATCTAAAGTTG	ACAAATCTAAAGTTG	1	1
ACGAGTTAGTAATAT	ACGAGTTAGTAATAT	1	1
CAAATTACGCATGTT	CAAATTACGCATGTT	2	1
TTGATTATTTACACA	TTGATTATTTACACA	1	1
GGCAGAGTCTAGAAT	GGCAGAGTCTAGAAT	1	1
TTAACGGGAGTCTGC	TTAACGGGAGTCTGC	6	1
ACGCCTCGAGACGCG	ACGCCTCGAGACGCG	9	1
GGGTATGGAAAAGTT	GGGTATGGAAAAGTT	12	1
CAGAGATTCAACTCT	CAGAGATTCAACTCT	2	1
GATTCTTAAACATTC	GATTCTTAAACATTC	2	1
ATGTTAACTGGTTCC	ATGTTAACTGGTTCC	1	1
CATGCCCATCACGTT	CATGCCCATCACGTT	1	1
ATATATACTTGTATA	ATATATACTTGTATA	1	1
AATTGTCTACAGCTT	AATTGTCTACAGCTT	3	1
CATTCAACGGTTACA	CATTCAACGGTTACA	3	1
CAACCTTGTCACATT	CAACCTTGTCACATT	3	1
TATGCAAATCTTATG	TATGCAAATCTTATG	3	1
TCTGGGAGATCCATA	TCTGGGAGATCCATA	1	1
TGCTGATTCTTTACA	TGCTGATTCTTTACA	1	1
AAGTGCGAATGCCGT	AAGTGCGAATGCCGT	2	1
TACACGAGGATGATG	TACACGAGGATGATG	1	1
TGTATTGCGAAGTTT	TGTATTGCGAAGTTT	3	1
GATTCTTAGTACCGG	GATTCTTAGTACCGG	7	1
ATATATAGAATTACC	ATATATAGAATTACC	1	1
TAATCCGTTAGAGTT	TAATCCGTTAGAGTT	1	1
TTCTTGCACGTACTC	TTCTTGCACGTACTC	1	1
TGCTGAAACGATGAA	TGCTGAAACGATGAA	2	1
TACCATACTTGGGTT	TACCATACTTGGGTT	2	1
GCGGGGTATTTACAA	GCGGGGTATTTACAA	2	1
GAGTCCTATACTATG	GAGTCCTATACTATG	2	1
GTCGGTGCGATTATA	GTCGGTGCGATTATA	1	1
AGTGCTAATCACCTA	AGTGCTAATCACCTA	5	1
AAAATACGACTTTAC	AAAATACGACTTTAC	2	1
AAAAAGACTAATTGT	AAAAAGACTAATTGT	2	1
TCTGATTAGTGAAAA	TCTGATTAGTGAAAA	1	1
GCTGTGCCTCCAATA	GCTGTGCCTCCAATA	1	1
GTAATAGGCACTTAA	GTAATAGGCACTTAA	1	1
GGCTACCGTTAAATT	GGCTACCGTTAAATT	3	1
GCTTACGTTTCTACA	GCTTACGTTTCTACA	3	1
GATATTCGGTTAAGG	GATATTCGGTTAAGG	3	1
TGGTGCCCGGCAGGG	TGGTGCCCGGCAGGG	4	1
AAGAGCACGTTTCGT	AAGAGCACGTTTCGT	2	1
TTCACTGCATAGCAA	TTCACTGCATAGCAA	2	1
ATAATCCGTACGCAG	ATAATCCGTACGCAG	1	1
GTTTTCCTGTCCGTG	GTTTTCCTGTCCGTG	1	1
TGATGCATTTCCTTT	TGATGCATTTCCTTT	1	1
TAACCTTTCTAATTA	TAACCTTTCTAATTA	2	1
ACTTACTCCTTATCT	ACTTACTCCTTATCT	2	1
GAAGGGTGTAGTTCG	GAAGGGTGTAGTTCG	2	1
GTTTGATTGACTTAT	GTTTGATTGACTTAT	1	1
ATACCTTATCGTCAT	ATACCTTATCGTCAT	1	1
GCGAATGGATGCGCG	GCGAATGGATGCGCG	1	1
TCTTTTTAGCTATCT	TCTTTTTAGCTATCT	1	1
CAAAACTGGTAAATC	CAAAACTGGTAAATC	1	1
CTACGTCATGCCGCT	CTACGTCATGCCGCT	3	1
GTTGGTTGAAAGATT	GTTGGTTGAAAGATT	1	1
ATTATAAAAGCAGTT	ATTATAAAAGCAGTT	3	1
GTAAGTCAGACTATG	GTAAGTCAGACTATG	2	1
TTAGGACCCTCTAGA	TTAGGACCCTCTAGA	2	1
GTATATTTTTTTAAC	GTATATTTTTTTAAC	1	1
ATTATCGCCCTTTCT	ATTATCGCCCTTTCT	3	1
ATTGTTAGCACTTAA	ATTGTTAGCACTTAA	7	1
CCTGCGGAGACAACC	CCTGCGGAGACAACC	12	1
GTCAGAGTAACAATA	GTCAGAGTAACAATA	3	1
CACAGGTGGGTACCT	CACAGGTGGGTACCT	1	1
TAAATTTATGTGGCT	TAAATTTATGTGGCT	2	1
TCGTCGCGTGATTAC	TCGTCGCGTGATTAC	5	1
TGGCTGTGTGAGATT	TGGCTGTGTGAGATT	7	1
CAGCCCATGTAAACT	CAGCCCATGTAAACT	2	1
TTTTTGGTAATTCTA	TTTTTGGTAATTCTA	4	1
TTTATACCATATGGA	TTTATACCATATGGA	1	1
TAAAATCGGATCCGA	TAAAATCGGATCCGA	3	1
TTGGTGACGTGGCGA	TTGGTGACGTGGCGA	1	1
CGAGGGTTCTAGGGT	CGAGGGTTCTAGGGT	2	1
AGTTAAGCACAGATT	AGTTAAGCACAGATT	2	1
AATGAAGGAGATGTG	AATGAAGGAGATGTG	1	1
CCACAACATTCTCCT	CCACAACATTCTCCT	1	1
CTAGCGGTGGGGTGG	CTAGCGGTGGGGTGG	1	1
AGAAACTGTTGAGGC	AGAAACTGTTGAGGC	2	1
ACCCCCGAAGTTAAA	ACCCCCGAAGTTAAA	1	1
CTTTCCGGTACATCA	CTTTCCGGTACATCA	3	1
GGTTGAGGGGGATAA	GGTTGAGGGGGATAA	1	1
AACTATCCCATGTTA	AACTATCCCATGTTA	3	1
TAGGTGCTTTGTGAG	TAGGTGCTTTGTGAG	1	1
CACCTCAGGTGTCAT	CACCTCAGGTGTCAT	1	1
TGCTGCTTCACAATA	TGCTGCTTCACAATA	1	1
ATAGGTTAGCTAATG	ATAGGTTAGCTAATG	1	1
ACAGGAACTTTGGGT	ACAGGAACTTTGGGT	2	1
CCTTCCGACTCATTA	CCTTCCGACTCATTA	3	1
TCGAGTAAGTCTTAC	TCGAGTAAGTCTTAC	1	1
GGGGGATTTTAGCTT	GGGGGATTTTAGCTT	3	1
TTGTTAGACTTTCTC	TTGTTAGACTTTCTC	1	1
CGACAAAAAAATTTG	CGACAAAAAAATTTG	1	1
TATACTAATTATATG	TATACTAATTATATG	2	1
TACCAGCTTAATCTC	TACCAGCTTAATCTC	4	1
CGTTTACCAAGTATG	CGTTTACCAAGTATG	2	1
CACTTCGTGACTTTT	CACTTCGTGACTTTT	1	1
CGATTTTAATCTTTA	CGATTTTAATCTTTA	3	1
GACATCATCGAATTG	GACATCATCGAATTG	2	1
ATCCCTATGGATCTT	ATCCCTATGGATCTT	2	1
AAAGACAAGCAAGGT	AAAGACAAGCAAGGT	1	1
TACAGGGGGGGGTAG	TACAGGGGGGGGTAG	6	1
GACCCTCATAACTCG	GACCCTCATAACTCG	1	1
TTATTGTCACTCCGA	TTATTGTCACTCCGA	2	1
TCATGTGTTTTTAAT	TCATGTGTTTTTAAT	1	1
CAAAGCGATCGTCTG	CAAAGCGATCGTCTG	2	1
CTTCTAGTTACAAAT	CTTCTAGTTACAAAT	1	1
ATATCTCAGGAGAAT	ATATCTCAGGAGAAT	1	1
GTGGGGGGTTTATGC	GTGGGGGGTTTATGC	2	1
CTTACGAAGGCGGCT	CTTACGAAGGCGGCT	3	1
GGCTGATTGTACTTA	GGCTGATTGTACTTA	1	1
TTTGCCTAGATTCAA	TTTGCCTAGATTCAA	2	1
GGTAAGGTACCGTAA	GGTAAGGTACCGTAA	7	1
AAATTAGTAAATCTA	AAATTAGTAAATCTA	1	1
TTACCGGATTAAGGT	TTACCGGATTAAGGT	2	1
TCTCAGGATACTTCA	TCTCAGGATACTTCA	2	1
CAGGAAGGGATGTTA	CAGGAAGGGATGTTA	3	1
ACGGCACAATAAACT	ACGGCACAATAAACT	2	1
GGTGGTGGCGATATG	GGTGGTGGCGATATG	1	1
TGTGTCATAGTATTC	TGTGTCATAGTATTC	1	1
GGGTACTTCAACCCT	GGGTACTTCAACCCT	1	1
ACTCTCCTGGTTTAC	ACTCTCCTGGTTTAC	2	1
TTACACATTTATCCC	TTACACATTTATCCC	2	1
TATAGCTCTGTGTGG	TATAGCTCTGTGTGG	2	1
AATGCTGTCTCGTGT	AATGCTGTCTCGTGT	4	1
ATGGGTCTTCAGGAT	ATGGGTCTTCAGGAT	2	1
GTATCCCGTATGCAT	GTATCCCGTATGCAT	4	1
TCCTCTGCTACTTTA	TCCTCTGCTACTTTA	2	1
GAGCGGAGATTACTC	GAGCGGAGATTACTC	1	1
CGTTTTTTCATCGAC	CGTTTTTTCATCGAC	5	1
TCAAACATTGCTTAC	TCAAACATTGCTTAC	1	1
CAAGTTACGTTGCCA	CAAGTTACGTTGCCA	3	1
TGATTGTGCAGGGGG	TGATTGTGCAGGGGG	3	1
CAAAGAACATAGAGC	CAAAGAACATAGAGC	1	1
GTCAATAGTAATTAT	GTCAATAGTAATTAT	4	1
TAACACCACATCAAT	TAACACCACATCAAT	10	1
ACATCCTATTGTCTG	ACATCCTATTGTCTG	1	1
TTTTGTACATCAATA	TTTTGTACATCAATA	2	1
TATTACGTTTATTGT	TATTACGTTTATTGT	1	1
GTGAGGTCGGGTTTG	GTGAGGTCGGGTTTG	2	1
TCTAAGTGTATAAGT	TCTAAGTGTATAAGT	9	1
CCGGTCTTCTTCTTT	CCGGTCTTCTTCTTT	1	1
GCCGAGGCGCGTTGG	GCCGAGGCGCGTTGG	1	1
TATGGCTATTCTTAC	TATGGCTATTCTTAC	4	1
GAGGCCTGCATTAAC	GAGGCCTGCATTAAC	1	1
AGCACCTTCTGGCAA	AGCACCTTCTGGCAA	5	1
TCGATTACTGTTAAG	TCGATTACTGTTAAG	3	1
TTAACCATAATGTCT	TTAACCATAATGTCT	1	1
GTAGGAGGCGAGGGG	GTAGGAGGCGAGGGG	2	1
ATTGTGTTAGTTCAA	ATTGTGTTAGTTCAA	3	1
CAAAAGTGCACGTTA	CAAAAGTGCACGTTA	2	1
CTCTGTTGGAGCTAA	CTCTGTTGGAGCTAA	3	1
ATCGGTAAAGATGTT	ATCGGTAAAGATGTT	2	1
TTTACGTTTGGTAAA	TTTACGTTTGGTAAA	2	1
CAAACAGGGCAAGGC	CAAACAGGGCAAGGC	3	1
GGCAGTGTCAGTGCG	GGCAGTGTCAGTGCG	1	1
ACGATACACAAACTG	ACGATACACAAACTG	1	1
CGAAACCGGAATATG	CGAAACCGGAATATG	2	1
ACAATTCCGCTTTTA	ACAATTCCGCTTTTA	1	1
AAGTAGGTTCTTGTT	AAGTAGGTTCTTGTT	1	1
ATCACATATGGATCG	ATCACATATGGATCG	2	1
AAACTCTGCAATAAT	AAACTCTGCAATAAT	1	1
CAGTATTATAACATC	CAGTATTATAACATC	1	1
CGAGATCCTTTATAA	CGAGATCCTTTATAA	3	1
GAGCTTTACCGTGTA	GAGCTTTACCGTGTA	2	1
TGCTCAATGTATCCT	TGCTCAATGTATCCT	1	1
GTGACAGTGTGTTTA	GTGACAGTGTGTTTA	2	1
AATAGTAGCTACTGT	AATAGTAGCTACTGT	2	1
CAGACTCTTCGTAAA	CAGACTCTTCGTAAA	3	1
TAAATGGTCTACATC	TAAATGGTCTACATC	4	1
AATTTCCTTGTGCGA	AATTTCCTTGTGCGA	2	1
CTTAATTAGAATTCT	CTTAATTAGAATTCT	2	1
ACTATTCTAGTCTGG	ACTATTCTAGTCTGG	1	1
GTAACTGGCGTCGGG	GTAACTGGCGTCGGG	1	1
CAAATACTGGCTTAA	CAAATACTGGCTTAA	1	1
CACCGCCCTTTTAAG	CACCGCCCTTTTAAG	4	1
CATGCACCTTCTTGT	CATGCACCTTCTTGT	3	1
CTATCACCACGTGAT	CTATCACCACGTGAT	2	1
ACCATAAATCATGTA	ACCATAAATCATGTA	2	1
TGAACACTCGGTAGT	TGAACACTCGGTAGT	2	1
CTTCGTGTATGTACA	CTTCGTGTATGTACA	2	1
ACATCATCTTAGAGT	ACATCATCTTAGAGT	1	1
TCGCTCTTATGACCA	TCGCTCTTATGACCA	1	1
TTCGTGCGCGGCGGA	TTCGTGCGCGGCGGA	1	1
ACATTAGGAAGGTGG	ACATTAGGAAGGTGG	9	1
GTTCTTATAACTCGG	GTTCTTATAACTCGG	2	1
TTCGACCAACTGTAT	TTCGACCAACTGTAT	1	1
TACGGGCAGGGCGAG	TACGGGCAGGGCGAG	2	1
GGAAGCCGGGGCTGG	GGAAGCCGGGGCTGG	1	1
AGTCTTCTTTTCCAA	AGTCTTCTTTTCCAA	1	1
CCTTTAAGAAATGGT	CCTTTAAGAAATGGT	3	1
TGGCCATCAGCTAAG	TGGCCATCAGCTAAG	3	1
TTCAGGCTCGATTCG	TTCAGGCTCGATTCG	2	1
TAAGGCACAATGCGT	TAAGGCACAATGCGT	2	1
AAGGATGGGGTACCA	AAGGATGGGGTACCA	1	1
GAAAGGACTCTTCTG	GAAAGGACTCTTCTG	4	1
GTTGTTGGTCGTGTC	GTTGTTGGTCGTGTC	7	1
AGTATAGGCCTGTGA	AGTATAGGCCTGTGA	3	1
TGAGAGCTCCCCCAG	TGAGAGCTCCCCCAG	11	1
TCGCAGTATTCGACA	TCGCAGTATTCGACA	4	1
GTCTGGAGCTAAAAT	GTCTGGAGCTAAAAT	3	1
ACAATAGATAAGCTT	ACAATAGATAAGCTT	3	1
TCCTAAAGCTGAACC	TCCTAAAGCTGAACC	2	1
ATCACTCTTCATGAA	ATCACTCTTCATGAA	2	1
TAATCCCATAGTCCT	TAATCCCATAGTCCT	2	1
TCGCGTTTAGGTGTT	TCGCGTTTAGGTGTT	1	1
GTACTAGGCGATCCT	GTACTAGGCGATCCT	1	1
AGTCACGCCAATGCC	AGTCACGCCAATGCC	1	1
TTTGTTCTTTTTTGA	TTTGTTCTTTTTTGA	1	1
TAAGATTGTGTAATT	TAAGATTGTGTAATT	1	1
GGTCCTGAGGATGGT	GGTCCTGAGGATGGT	2	1
TAACGGTGGGGTAGC	TAACGGTGGGGTAGC	1	1
AAGGTGGTGCGCGGT	AAGGTGGTGCGCGGT	2	1
ACGGTTTATTATCCA	ACGGTTTATTATCCA	5	1
GGATGGTAATTGTAC	GGATGGTAATTGTAC	1	1
GAATTCCTTCCCGTC	GAATTCCTTCCCGTC	1	1
ATAGCTATCTCGGCT	ATAGCTATCTCGGCT	1	1
GCCATACCTCCTCTT	GCCATACCTCCTCTT	2	1
TGTGAGTCGAGGTTT	TGTGAGTCGAGGTTT	2	1
TTAACTTGTCGCCTG	TTAACTTGTCGCCTG	5	1
TCTGAGAAGTCTGGG	TCTGAGAAGTCTGGG	6	1
ACCTGCTGTGGCGGA	ACCTGCTGTGGCGGA	2	1
ATCCGAGTAAGTAAT	ATCCGAGTAAGTAAT	3	1
TAAATGGCCGTCAAT	TAAATGGCCGTCAAT	1	1
ATTCCGGATATTTAT	ATTCCGGATATTTAT	4	1
TAGTTGTTGTTTTAG	TAGTTGTTGTTTTAG	1	1
CATCATATTCTGCAA	CATCATATTCTGCAA	6	1
TTAGTTCCGTAACTT	TTAGTTCCGTAACTT	4	1
TAATGGTGATAGTCA	TAATGGTGATAGTCA	1	1
CAGTGACACCATGAT	CAGTGACACCATGAT	2	1
ATAACATTGCATTAC	ATAACATTGCATTAC	2	1
TCGAATAGCTGCGTC	TCGAATAGCTGCGTC	1	1
ATTGGATCTTGGGCT	ATTGGATCTTGGGCT	1	1
AGGCATGAAAAGAAG	AGGCATGAAAAGAAG	2	1
CGCCAACAGAAACGT	CGCCAACAGAAACGT	5	1
AGAAAGTCATAACAA	AGAAAGTCATAACAA	1	1
CTTGGGTAAAATCGT	CTTGGGTAAAATCGT	2	1
GGTAATCGTCGGTGG	GGTAATCGTCGGTGG	1	1
TATCGATTGAGGAAA	TATCGATTGAGGAAA	2	1
GAGATCGTGAGTGTT	GAGATCGTGAGTGTT	1	1
TTGTAGTTCACGTCT	TTGTAGTTCACGTCT	1	1
GTTGCGTATTGATTT	GTTGCGTATTGATTT	1	1
GGGCGTGTACAATTT	GGGCGTGTACAATTT	2	1
ATCTCTTTTGCCTGG	ATCTCTTTTGCCTGG	2	1
TAAAGCTGTAAACAT	TAAAGCTGTAAACAT	2	1
TTGTCTAGCTGCGAC	TTGTCTAGCTGCGAC	3	1
GCATAGTCATTAGGT	GCATAGTCATTAGGT	2	1
TAACTGCTTGCTGTA	TAACTGCTTGCTGTA	3	1
TATTCATCGGTCCCT	TATTCATCGGTCCCT	1	1
GATCTGTTCTCTGCT	GATCTGTTCTCTGCT	1	1
ACATTGGCGTCGTGT	ACATTGGCGTCGTGT	1	1
GCCGGTATGGATAGG	GCCGGTATGGATAGG	1	1
TATCTTGGACATCTG	TATCTTGGACATCTG	4	1
AAAATATTTTGGCTG	AAAATATTTTGGCTG	1	1
TTTATTTGTCACAAA	TTTATTTGTCACAAA	1	1
CTATTTTCTCTATAT	CTATTTTCTCTATAT	3	1
GTTATCCGGACGTTA	GTTATCCGGACGTTA	2	1
AATTTACAGTTGGTC	AATTTACAGTTGGTC	19	1
AATTCGGATTAACTC	AATTCGGATTAACTC	6	1
ATTCGCATATTCTTG	ATTCGCATATTCTTG	2	1
ATCCCGGCTGAATTG	ATCCCGGCTGAATTG	4	1
TTTAGACGGTCCCAT	TTTAGACGGTCCCAT	7	1
GTCGATGCTAAAGTA	GTCGATGCTAAAGTA	2	1
AGTTTGTCCAAATGA	AGTTTGTCCAAATGA	1	1
TGAGGCATGTGATAT	TGAGGCATGTGATAT	2	1
CCCATCAGAAAGCTT	CCCATCAGAAAGCTT	1	1
CATACTACCTATTTG	CATACTACCTATTTG	1	1
ATATCGAGGGCGGCT	ATATCGAGGGCGGCT	1	1
TAGAGTAGATCGCGT	TAGAGTAGATCGCGT	1	1
GTTTATACATTTCGT	GTTTATACATTTCGT	3	1
CTATATTTCTCGTCA	CTATATTTCTCGTCA	5	1
CAACGTCAGACTTCT	CAACGTCAGACTTCT	1	1
AATAGAGCTGTTACA	AATAGAGCTGTTACA	2	1
TTGGTGCAGCTTGAG	TTGGTGCAGCTTGAG	7	1
CTCTGCATTTGTTTT	CTCTGCATTTGTTTT	2	1
TCGAGCTGCGACCTT	TCGAGCTGCGACCTT	1	1
TATCAGGCATACGTG	TATCAGGCATACGTG	5	1
CACACGCGCGTGTAT	CACACGCGCGTGTAT	1	1
TAGGCAGACGGAACA	TAGGCAGACGGAACA	2	1
CAAATATAATTAGTG	CAAATATAATTAGTG	2	1
GCTATTAGACGTACA	GCTATTAGACGTACA	2	1
ACTAATGCATCCCCA	ACTAATGCATCCCCA	1	1
GTTGGTATGTATCGA	GTTGGTATGTATCGA	2	1
TAATATGCACTTTTT	TAATATGCACTTTTT	1	1
TACGTGCGCGCATAT	TACGTGCGCGCATAT	2	1
GAAAAACACATGACG	GAAAAACACATGACG	1	1
CACAACCTATAGAAC	CACAACCTATAGAAC	1	1
CTTGTCGATTTTGTA	CTTGTCGATTTTGTA	1	1
TTTGCCTTATGTCCG	TTTGCCTTATGTCCG	1	1
CAAATATTCCCGGTG	CAAATATTCCCGGTG	2	1
TGAGTTCAGTAAATT	TGAGTTCAGTAAATT	3	1
GAATGAGAAATCTAC	GAATGAGAAATCTAC	2	1
CTAATGTTAGGGTAA	CTAATGTTAGGGTAA	2	1
GGATCACGCTAACAC	GGATCACGCTAACAC	2	1
CGTGCCAGGAAACTA	CGTGCCAGGAAACTA	1	1
GGACATAACTATGTT	GGACATAACTATGTT	1	1
GGATATATGTTGTAT	GGATATATGTTGTAT	2	1
ATCTTAGCAGACGTT	ATCTTAGCAGACGTT	1	1
TGTCATCGAATTGAA	TGTCATCGAATTGAA	2	1
GCAACATCATTATTC	GCAACATCATTATTC	1	1
TTCGGGCGTGCTGGA	TTCGGGCGTGCTGGA	16	1
ATAGCGTGTGTGGCG	ATAGCGTGTGTGGCG	6	1
ATGATTTATCGTTTC	ATGATTTATCGTTTC	1	1
AGTAGCAGCGAAGAG	AGTAGCAGCGAAGAG	3	1
GTTACGTGGTTTTTT	GTTACGTGGTTTTTT	1	1
CGGAAAGTTCTGGAT	CGGAAAGTTCTGGAT	1	1
CTCACACCGATATAG	CTCACACCGATATAG	1	1
ACTGCACACATTCTA	ACTGCACACATTCTA	1	1
CTTGGTGAGAATTAA	CTTGGTGAGAATTAA	3	1
TAATCGTTCATAATA	TAATCGTTCATAATA	6	1
AAATGGAGAAGGTTT	AAATGGAGAAGGTTT	1	1
ATATCTAATAATTTG	ATATCTAATAATTTG	1	1
GGAAAACTCATATGT	GGAAAACTCATATGT	1	1
CATTGGCATTACAGT	CATTGGCATTACAGT	1	1
GGTCTACAGGTGGGA	GGTCTACAGGTGGGA	3	1
CTCGGTAGGGGTATG	CTCGGTAGGGGTATG	1	1
GCGGTGGGGATATCA	GCGGTGGGGATATCA	2	1
AATGCGTGCTCGTTT	AATGCGTGCTCGTTT	2	1
CCAATACTTTTAAAA	CCAATACTTTTAAAA	1	1
GGTGCTACAAAGGTA	GGTGCTACAAAGGTA	2	1
GACTTACATTCATAG	GACTTACATTCATAG	3	1
GTTAGCAATAGATGT	GTTAGCAATAGATGT	3	1
TTCTGTACATCTAGT	TTCTGTACATCTAGT	1	1
AACGGCGACGCGTTT	AACGGCGACGCGTTT	1	1
TGTGGTCTGCGAATT	TGTGGTCTGCGAATT	1	1
AAAATATTAGCAACT	AAAATATTAGCAACT	1	1
ACAATGGTTCAGTTT	ACAATGGTTCAGTTT	2	1
GACAATCAATTGTAA	GACAATCAATTGTAA	1	1
AGGTGCTGATTCGGA	AGGTGCTGATTCGGA	1	1
GTCGCTTTTTATAAT	GTCGCTTTTTATAAT	3	1
AAGGAAAGATTGCCA	AAGGAAAGATTGCCA	2	1
ACTTTTGTCCCGCAG	ACTTTTGTCCCGCAG	2	1
TGGGTAGACAAATAG	TGGGTAGACAAATAG	1	1
GGAGTAACAATGTTA	GGAGTAACAATGTTA	3	1
ACTCTAGTCTAGCGA	ACTCTAGTCTAGCGA	1	1
AGGGGCCAGTGTTGT	AGGGGCCAGTGTTGT	7	1
ATTATGAATAAGACA	ATTATGAATAAGACA	3	1
TCGCATACCGCATCT	TCGCATACCGCATCT	5	1
GGGCTTATATATGTG	GGGCTTATATATGTG	1	1
GGTACGACAATAGTA	GGTACGACAATAGTA	1	1
CATTCACTTCAACTT	CATTCACTTCAACTT	1	1
CCAAGAATGCGTAAC	CCAAGAATGCGTAAC	3	1
ACACCATGTTTACTG	ACACCATGTTTACTG	1	1
TGGTACCAAATGTCG	TGGTACCAAATGTCG	1	1
GGAAAGTCGTACGTG	GGAAAGTCGTACGTG	1	1
CGGTGCGCGGTGGGA	CGGTGCGCGGTGGGA	1	1
TGTAGTATATACGGA	TGTAGTATATACGGA	1	1
TCCTTCCTTTTGATA	TCCTTCCTTTTGATA	4	1
ACTTTCTGCTTAACT	ACTTTCTGCTTAACT	1	1
CTAGGGATCTACATG	CTAGGGATCTACATG	2	1
GAGTAGTTACAAGTT	GAGTAGTTACAAGTT	3	1
TTACTCGTTTTTAGT	TTACTCGTTTTTAGT	1	1
TGGCGCTCTGTCCAA	TGGCGCTCTGTCCAA	2	1
AAGTGGTTCTACTAG	AAGTGGTTCTACTAG	4	1
ACCCGCGAAGTTAAA	ACCCGCGAAGTTAAA	3	1
CGTTTATTGTAATAT	CGTTTATTGTAATAT	2	1
CTCGTAATAACATCA	CTCGTAATAACATCA	1	1
CACTTCCGGTCTTAT	CACTTCCGGTCTTAT	1	1
ACATCTTGTCGTTAT	ACATCTTGTCGTTAT	2	1
ATGGCTGTCGCTAGT	ATGGCTGTCGCTAGT	2	1
TACTGTGGATTTACT	TACTGTGGATTTACT	1	1
GGTCTCTTCTTAAAT	GGTCTCTTCTTAAAT	1	1
GGAGCGGTGCATCGG	GGAGCGGTGCATCGG	2	1
GAGGGCCGGATGGGG	GAGGGCCGGATGGGG	7	1
AACATTCTGTATGGT	AACATTCTGTATGGT	3	1
ACATTGCTATAATTA	ACATTGCTATAATTA	1	1
GGTCAACCGTAGGTG	GGTCAACCGTAGGTG	1	1
CCTTAGGTTAATATC	CCTTAGGTTAATATC	2	1
AATGTCAAAATATAT	AATGTCAAAATATAT	1	1
TACCTTTGTAAATAC	TACCTTTGTAAATAC	2	1
ATTTTTATTAGCGCT	ATTTTTATTAGCGCT	1	1
GTTCCAGCTGAAATT	GTTCCAGCTGAAATT	5	1
CATTGGATGACGGTG	CATTGGATGACGGTG	6	1
TCGACACTCTCCATG	TCGACACTCTCCATG	4	1
CTTAGTACCTACCTC	CTTAGTACCTACCTC	1	1
TTCCGCGGTGGCGAG	TTCCGCGGTGGCGAG	3	1
GCCGACACCTCCCCC	GCCGACACCTCCCCC	2	1
CTTCATTTATTTTTG	CTTCATTTATTTTTG	2	1
CCACTCCGTAATGTG	CCACTCCGTAATGTG	2	1
TCTTCCGGACCTTCA	TCTTCCGGACCTTCA	1	1
GTCGGAAAGGGTGTG	GTCGGAAAGGGTGTG	1	1
TCGATTGGGATTAGT	TCGATTGGGATTAGT	1	1
TAAATGAATACGGTA	TAAATGAATACGGTA	1	1
GTTCATAAAATTGCT	GTTCATAAAATTGCT	1	1
AAGCGCCTAGCATGA	AAGCGCCTAGCATGA	1	1
TCTGTTATAGTTGAT	TCTGTTATAGTTGAT	2	1
ATTTCTGCCGAATAT	ATTTCTGCCGAATAT	2	1
ACGCACTTTTTTCAC	ACGCACTTTTTTCAC	1	1
ACACGGAGCTACTCA	ACACGGAGCTACTCA	1	1
ACATTGTTTGTGTGT	ACATTGTTTGTGTGT	1	1
AGGGCGCATTAGACA	AGGGCGCATTAGACA	2	1
TTTCTATGATGAGAT	TTTCTATGATGAGAT	3	1
AGGAGGGGGGTCCCC	AGGAGGGGGGTCCCC	5	1
TGAACTTCGGTGGCA	TGAACTTCGGTGGCA	3	1
GTAGTCGGGTAGAGC	GTAGTCGGGTAGAGC	4	1
GAGGCAGGTTCATAA	GAGGCAGGTTCATAA	3	1
TATACGGTGGGCGGG	TATACGGTGGGCGGG	1	1
TCTCGGGGGGCGAGG	TCTCGGGGGGCGAGG	1	1
GTATATTTTGCAGGT	GTATATTTTGCAGGT	1	1
GATCTTAATATCGTG	GATCTTAATATCGTG	1	1
ATTTTGCTGTCATGC	ATTTTGCTGTCATGC	2	1
CTTGGGTAGTGGCAT	CTTGGGTAGTGGCAT	3	1
CCCAAGTAAATCTAG	CCCAAGTAAATCTAG	10	1
ATATGGAAGGGAAGG	ATATGGAAGGGAAGG	1	1
TAGTTGGGTCTGGGG	TAGTTGGGTCTGGGG	1	1
TCGCATTCCCTATGA	TCGCATTCCCTATGA	2	1
TATTCAATTGGATAT	TATTCAATTGGATAT	2	1
ACGTGTGTAGGTGAT	ACGTGTGTAGGTGAT	1	1
GCTCGTTTGTAGCAT	GCTCGTTTGTAGCAT	2	1
GATACGATTTGATTC	GATACGATTTGATTC	1	1
TACTTAAGTGGTCTG	TACTTAAGTGGTCTG	1	1
CATGCCACGCTGGGA	CATGCCACGCTGGGA	1	1
CAAGTTAGCGTTTTG	CAAGTTAGCGTTTTG	3	1
CTCACCGTTACCTTA	CTCACCGTTACCTTA	1	1
GTTACGCGGGCAAGG	GTTACGCGGGCAAGG	2	1
CTTTTCACTTAGACT	CTTTTCACTTAGACT	1	1
CGTTTAGGCAAGCGA	CGTTTAGGCAAGCGA	2	1
GTCTACGCAAATCAA	GTCTACGCAAATCAA	1	1
GGGGTTCAACAGAGT	GGGGTTCAACAGAGT	4	1
AAAGCCAACATTCAT	AAAGCCAACATTCAT	1	1
ATTCGTTCCCTACTG	ATTCGTTCCCTACTG	1	1
AAGTGTCTGCTGTTT	AAGTGTCTGCTGTTT	4	1
TTACTATAGAATACT	TTACTATAGAATACT	3	1
AATTGAAAGTTACTT	AATTGAAAGTTACTT	1	1
GTACAAGTGGGACCT	GTACAAGTGGGACCT	2	1
GTCGTAAGGGGGAAG	GTCGTAAGGGGGAAG	3	1
ATCTTGTCAGTGATA	ATCTTGTCAGTGATA	1	1
TCTGGTCGGGGCAAG	TCTGGTCGGGGCAAG	3	1
CTTAACCCTTAACCT	CTTAACCCTTAACCT	1	1
ATTTCCGGCGTCTTT	ATTTCCGGCGTCTTT	2	1
ATCCGGCTCATGTTT	ATCCGGCTCATGTTT	1	1
TCAGCGCGGAATTAG	TCAGCGCGGAATTAG	3	1
TGGCAGTTCTAATAC	TGGCAGTTCTAATAC	1	1
AAGAACGTGCCTCCG	AAGAACGTGCCTCCG	3	1
TTCATGTAAAGCTTT	TTCATGTAAAGCTTT	3	1
CTTTTCTTAATTTCT	CTTTTCTTAATTTCT	2	1
CGGAGCTCTGTAAAC	CGGAGCTCTGTAAAC	8	1
TAGCGTGAGGATCGT	TAGCGTGAGGATCGT	2	1
TCTGCCCTGATGTTT	TCTGCCCTGATGTTT	2	1
GTATCAACATCTTAG	GTATCAACATCTTAG	1	1
TGCTTTACAATTGGT	TGCTTTACAATTGGT	3	1
GCACATCTTTCGAAA	GCACATCTTTCGAAA	2	1
TCACCTATTGTTACA	TCACCTATTGTTACA	1	1
AGAACGGTTTATATT	AGAACGGTTTATATT	1	1
CGGTTGTAACCTCTC	CGGTTGTAACCTCTC	1	1
ACGTTCACGTCCTAA	ACGTTCACGTCCTAA	4	1
TTTAGGGAACCAACA	TTTAGGGAACCAACA	3	1
TATACGCTTTCATGT	TATACGCTTTCATGT	1	1
TTGACAATGTATATA	TTGACAATGTATATA	1	1
TATCCGCTGCAGTCT	TATCCGCTGCAGTCT	1	1
TATCAGAAAGATTTT	TATCAGAAAGATTTT	1	1
TGTAAACACTAACTG	TGTAAACACTAACTG	1	1
AAATATCCTGGAAAA	AAATATCCTGGAAAA	1	1
AAAGCTGATTGGCTG	AAAGCTGATTGGCTG	4	1
TTGGCATTAATGATA	TTGGCATTAATGATA	3	1
TCACAATCCTCCATT	TCACAATCCTCCATT	1	1
CGAAAGTTCTATCTT	CGAAAGTTCTATCTT	1	1
TCAGTCTCTTAAACT	TCAGTCTCTTAAACT	2	1
GGCTCTTGTCTCTGA	GGCTCTTGTCTCTGA	1	1
GTGAATAGTAGCCCT	GTGAATAGTAGCCCT	1	1
GCTATATCGTAAGAT	GCTATATCGTAAGAT	4	1
ATAGGTTTTTGTTAA	ATAGGTTTTTGTTAA	4	1
CTTAGTCACCTCCTC	CTTAGTCACCTCCTC	2	1
ATACCTGCGTTTGGT	ATACCTGCGTTTGGT	2	1
GGACCTTAACAACGA	GGACCTTAACAACGA	2	1
ATGATGGTTTCTTAC	ATGATGGTTTCTTAC	3	1
GTTGGTGTATTTCTC	GTTGGTGTATTTCTC	2	1
GTCGTTAATCAATGT	GTCGTTAATCAATGT	1	1
AGCATCCAACTCTGT	AGCATCCAACTCTGT	4	1
TAGCAACGTGTTCTT	TAGCAACGTGTTCTT	1	1
AATCCGCTACCATTA	AATCCGCTACCATTA	2	1
TCAGGAAACTAGTCC	TCAGGAAACTAGTCC	1	1
TGTATGTGAATTAAA	TGTATGTGAATTAAA	3	1
TGATCTAAACGTGCT	TGATCTAAACGTGCT	2	1
CTTGAGAAATTCGTG	CTTGAGAAATTCGTG	1	1
GTTTCAATTCCTTCT	GTTTCAATTCCTTCT	1	1
TGTTGCACATAACAG	TGTTGCACATAACAG	2	1
TACGATTATTTGTCT	TACGATTATTTGTCT	2	1
GACACAATTAATTGC	GACACAATTAATTGC	2	1
CCTCCAGGACTAGTG	CCTCCAGGACTAGTG	2	1
ATATATCGTACAGTG	ATATATCGTACAGTG	1	1
TCATTGTCGTTTAGT	TCATTGTCGTTTAGT	1	1
TTACGCAATAGATTC	TTACGCAATAGATTC	1	1
GATGATTCTATATCG	GATGATTCTATATCG	2	1
AATCCATATCATAGT	AATCCATATCATAGT	1	1
TCGATCTAACTGGTC	TCGATCTAACTGGTC	1	1
ATTTTGCTTTATACT	ATTTTGCTTTATACT	2	1
TTCGTGGTATCCATA	TTCGTGGTATCCATA	2	1
GAGTCAATGCTAATT	GAGTCAATGCTAATT	1	1
TTTACAGATTCTTTT	TTTACAGATTCTTTT	1	1
CAAACTAAGGATGTA	CAAACTAAGGATGTA	3	1
CCGCAGCTTTGCGCG	CCGCAGCTTTGCGCG	3	1
TCGGACTAATCCATA	TCGGACTAATCCATA	1	1
ACTCTAAGCTTGATT	ACTCTAAGCTTGATT	1	1
CCTTGGGGTGACTTA	CCTTGGGGTGACTTA	1	1
ACTGATCCAGGAAAA	ACTGATCCAGGAAAA	3	1
GAAATGTCGATGAGA	GAAATGTCGATGAGA	2	1
GATAAACAAATCCGT	GATAAACAAATCCGT	4	1
GTAATCTAGGAGCAA	GTAATCTAGGAGCAA	2	1
ATACTACTTGACATA	ATACTACTTGACATA	3	1
CTTATAAGAACGTCT	CTTATAAGAACGTCT	1	1
AAGTCTAAGTTCCTT	AAGTCTAAGTTCCTT	1	1
GATACTTTCTTATGA	GATACTTTCTTATGA	3	1
GCATTACTAAATATC	GCATTACTAAATATC	1	1
GGACGAAAACATCTT	GGACGAAAACATCTT	1	1
TAGCCTTTGTTTTTT	TAGCCTTTGTTTTTT	1	1
AACTTTGAACAAATA	AACTTTGAACAAATA	1	1
TCCCGTGCGCCTAGA	TCCCGTGCGCCTAGA	4	1
CTTAGCGAATTTCAC	CTTAGCGAATTTCAC	1	1
AAGATTTTCATCTGA	AAGATTTTCATCTGA	1	1
TTTTTAAAATAGATT	TTTTTAAAATAGATT	1	1
TTTCTGCGTGTTTTC	TTTCTGCGTGTTTTC	2	1
CATTTACTGAACTGA	CATTTACTGAACTGA	1	1
TCGTGGTTTAATCGT	TCGTGGTTTAATCGT	3	1
GCATACCGTATCCTT	GCATACCGTATCCTT	1	1
CGCTTCTCGGAATGT	CGCTTCTCGGAATGT	1	1
GGGATTTTCGGTCAA	GGGATTTTCGGTCAA	1	1
GTTAGGTACTTCTTG	GTTAGGTACTTCTTG	1	1
TGTATATAATTCAAA	TGTATATAATTCAAA	2	1
TATCCTGCTATCGCA	TATCCTGCTATCGCA	1	1
GTGTTTAAATTGCGA	GTGTTTAAATTGCGA	1	1
GCTATCAGTGTGTTC	GCTATCAGTGTGTTC	1	1
TACCCATCGTATCAT	TACCCATCGTATCAT	1	1
CAGTTATAACAGTTA	CAGTTATAACAGTTA	1	1
GCGTTGTGTCTGTTT	GCGTTGTGTCTGTTT	1	1
ATTATGCACCTCTCA	ATTATGCACCTCTCA	4	1
ACTGTCCATATTAGA	ACTGTCCATATTAGA	3	1
AGTGGGCAGGTACAG	AGTGGGCAGGTACAG	1	1
GCAGTTTAGAGAATT	GCAGTTTAGAGAATT	1	1
CCATAAGTTGTCTTC	CCATAAGTTGTCTTC	5	1
ATATCAAAGACCCAA	ATATCAAAGACCCAA	3	1
GTTAAGGGTCGAAGC	GTTAAGGGTCGAAGC	5	1
TTACGGGCGAAAAGG	TTACGGGCGAAAAGG	5	1
AGAATAACTGAGGCT	AGAATAACTGAGGCT	3	1
ATTAAAAATTGACCA	ATTAAAAATTGACCA	2	1
CCAAATACGCATAGT	CCAAATACGCATAGT	1	1
CATAAATATACAATT	CATAAATATACAATT	1	1
AAGCAGGGTACGGTG	AAGCAGGGTACGGTG	1	1
GGACTGCATGGTTGT	GGACTGCATGGTTGT	4	1
GCTCGTTAGAACATG	GCTCGTTAGAACATG	3	1
TTTTCTCTTGTCTAT	TTTTCTCTTGTCTAT	2	1
GTGGTTTTAAATAAT	GTGGTTTTAAATAAT	1	1
AGCGTATAATCATAT	AGCGTATAATCATAT	2	1
CGTTGGTATTTTGTT	CGTTGGTATTTTGTT	1	1
GCCATAGTTAAATAA	GCCATAGTTAAATAA	3	1
GCAGTTGATAATAGT	GCAGTTGATAATAGT	1	1
TCGATCGGGTACCTC	TCGATCGGGTACCTC	1	1
CTTGCGCGGAATCAT	CTTGCGCGGAATCAT	6	1
CGTGCATACATATGT	CGTGCATACATATGT	2	1
TCTGCAACCTTTGCC	TCTGCAACCTTTGCC	2	1
TTACTCGTGGATAGG	TTACTCGTGGATAGG	3	1
TAAAACCATGACATA	TAAAACCATGACATA	1	1
AAATGTAAAATAGCC	AAATGTAAAATAGCC	2	1
AGGGTGAGGTTGTGT	AGGGTGAGGTTGTGT	2	1
AGAGGATAAACCTGA	AGAGGATAAACCTGA	2	1
TGGCATCCGGAAGTT	TGGCATCCGGAAGTT	1	1
TAAGTATGTTTAACT	TAAGTATGTTTAACT	1	1
AATTTTAGATCGATT	AATTTTAGATCGATT	1	1
CTAGACAAAATTCAC	CTAGACAAAATTCAC	1	1
GAAACGGCAGTCCGT	GAAACGGCAGTCCGT	1	1
TTCACCCATTATCTT	TTCACCCATTATCTT	2	1
TTTGAAAGCAATCCT	TTTGAAAGCAATCCT	3	1
ATGTCTAATACCATT	ATGTCTAATACCATT	1	1
TGAAGTACTGGCACT	TGAAGTACTGGCACT	1	1
CAATTTTACTCCGTG	CAATTTTACTCCGTG	1	1
ATTACATGCGCTCTT	ATTACATGCGCTCTT	2	1
ATGGTAACATTAGCA	ATGGTAACATTAGCA	2	1
CAGGCCCCCAGGGGG	CAGGCCCCCAGGGGG	1	1
TGTGCTAATCCGAGT	TGTGCTAATCCGAGT	4	1
ATTGACGAGAGGATA	ATTGACGAGAGGATA	1	1
TTGGCCCTAGTTTTG	TTGGCCCTAGTTTTG	1	1
CCTCTTTAAGCGCTA	CCTCTTTAAGCGCTA	1	1
TACAAATATACTTGT	TACAAATATACTTGT	3	1
TTTAATGCTTGAAAT	TTTAATGCTTGAAAT	1	1
GCCGGCAGTTGTGTA	GCCGGCAGTTGTGTA	3	1
TGCCAATTCCAATAG	TGCCAATTCCAATAG	5	1
AAACCCAGCTTTTAG	AAACCCAGCTTTTAG	3	1
TTTTCAGTGAGTCAA	TTTTCAGTGAGTCAA	1	1
TATTGTTTAAATTTA	TATTGTTTAAATTTA	3	1
TCGTTGAGCGCCCAT	TCGTTGAGCGCCCAT	3	1
GTCATTGTGTGGAGT	GTCATTGTGTGGAGT	8	1
GTCTGAGGCGCGTAC	GTCTGAGGCGCGTAC	1	1
ATTAGGCGGGAGAGG	ATTAGGCGGGAGAGG	2	1
AAAGCAGTGCGTGGC	AAAGCAGTGCGTGGC	1	1
TAATCTCGGCTCATA	TAATCTCGGCTCATA	1	1
CCGTCTTAACATTCT	CCGTCTTAACATTCT	2	1
CGTAGCATCGTTGTT	CGTAGCATCGTTGTT	3	1
TGTGGGTGGGAGTCC	TGTGGGTGGGAGTCC	1	1
TAATCAACTTTTGAA	TAATCAACTTTTGAA	2	1
CCTGGGAAAAATGTT	CCTGGGAAAAATGTT	1	1
CTTGAAAGGTATGTT	CTTGAAAGGTATGTT	2	1
CATCGAGGCGCTGTG	CATCGAGGCGCTGTG	2	1
CATAAGACTAATTAG	CATAAGACTAATTAG	2	1
TTCGCTTAGTAAAAG	TTCGCTTAGTAAAAG	1	1
TATATAAGCCTTATC	TATATAAGCCTTATC	3	1
GCTGTCGTCTCGATC	GCTGTCGTCTCGATC	1	1
GGGCAGTCTGGGTAG	GGGCAGTCTGGGTAG	1	1
TTTTCTCTGGGTGTT	TTTTCTCTGGGTGTT	2	1
GGACTCGTTGGCGAG	GGACTCGTTGGCGAG	1	1
ACATGAGTTAAAGCA	ACATGAGTTAAAGCA	1	1
GTTGAATCGCGCATT	GTTGAATCGCGCATT	2	1
ACCTTCACTGGTCCT	ACCTTCACTGGTCCT	2	1
CAAATTTAGGCAGGT	CAAATTTAGGCAGGT	1	1
TTTTCCGTATTCGTC	TTTTCCGTATTCGTC	1	1
GGCTGCTGGGAGGTG	GGCTGCTGGGAGGTG	2	1
GGATATGCATCGGAT	GGATATGCATCGGAT	4	1
ATTGAAACTCGATGT	ATTGAAACTCGATGT	3	1
ATGGGATGCGAACTT	ATGGGATGCGAACTT	1	1
TACGGTAACCGGTGT	TACGGTAACCGGTGT	1	1
CGCTGTGAGTCACGT	CGCTGTGAGTCACGT	1	1
ATAATTGGTATTGCA	ATAATTGGTATTGCA	4	1
ACAGTCCTGCAGATT	ACAGTCCTGCAGATT	2	1
CGGGCCGGTGTTATT	CGGGCCGGTGTTATT	2	1
AACATTCCCGTTTTA	AACATTCCCGTTTTA	2	1
TTCATATAGCAATGT	TTCATATAGCAATGT	1	1
TCATATAGCCATTCA	TCATATAGCCATTCA	1	1
GTATTCGGAGTTTAC	GTATTCGGAGTTTAC	1	1
GAATAGTACTATGTA	GAATAGTACTATGTA	2	1
GTGTTTAAGATTGAG	GTGTTTAAGATTGAG	2	1
CCTACGGCGACTATA	CCTACGGCGACTATA	1	1
TTTACACGTACTGCT	TTTACACGTACTGCT	2	1
GGACGGCGGTAAGTT	GGACGGCGGTAAGTT	2	1
TGACGCGTCGCATTT	TGACGCGTCGCATTT	1	1
CTGTAGATAATGCTC	CTGTAGATAATGCTC	1	1
ACTGAGATCTACGGC	ACTGAGATCTACGGC	3	1
ACTGTGAATATAAAT	ACTGTGAATATAAAT	5	1
TTACAAACTTATAAT	TTACAAACTTATAAT	2	1
CATCTCGTTGCCGAC	CATCTCGTTGCCGAC	1	1
CTTTCGGAGGTACAC	CTTTCGGAGGTACAC	1	1
GAATGACCTTCAATG	GAATGACCTTCAATG	1	1
CCCACTTTTTCTTTC	CCCACTTTTTCTTTC	1	1
GAGCGTCCTGATGAG	GAGCGTCCTGATGAG	1	1
ACAATTTACTTTGCA	ACAATTTACTTTGCA	3	1
GGAAGGATAGTTAAA	GGAAGGATAGTTAAA	4	1
TTACTTTTTAAGGTG	TTACTTTTTAAGGTG	1	1
CTTTGGTGGGGCAGG	CTTTGGTGGGGCAGG	1	1
ATAGGTCTGTACTAT	ATAGGTCTGTACTAT	2	1
TCCCCAGTCCTCAGG	TCCCCAGTCCTCAGG	4	1
CAGGTGTTGAAACGT	CAGGTGTTGAAACGT	1	1
TATTGCTAGCTAATT	TATTGCTAGCTAATT	2	1
TTCAGTTCCACAGTC	TTCAGTTCCACAGTC	5	1
ATTGCGTCCTCTCTC	ATTGCGTCCTCTCTC	1	1
GTCGACATGACATAA	GTCGACATGACATAA	2	1
CTGTGTCTATTTGGT	CTGTGTCTATTTGGT	5	1
GAATTCGTTGCTCCT	GAATTCGTTGCTCCT	1	1
AACATCGGCCCCATT	AACATCGGCCCCATT	4	1
AGCCTATGTATTGTA	AGCCTATGTATTGTA	1	1
GTATAAGGTGTCGTC	GTATAAGGTGTCGTC	5	1
GACGTTGAGCAAGTC	GACGTTGAGCAAGTC	1	1
AGTTTTAGTACAGAA	AGTTTTAGTACAGAA	1	1
GCGTTGGGAGTACAC	GCGTTGGGAGTACAC	1	1
GTGTATAGATGTCCT	GTGTATAGATGTCCT	1	1
TCTCAAGAAATATGT	TCTCAAGAAATATGT	1	1
AAATTCTGTAAAAAT	AAATTCTGTAAAAAT	1	1
ATAACATATGACTTT	ATAACATATGACTTT	4	1
TGACACGGCATGGGT	TGACACGGCATGGGT	1	1
ACACTGGGTTTACTT	ACACTGGGTTTACTT	1	1
TTCGACTGATTTGTG	TTCGACTGATTTGTG	3	1
CACTGTTCCATATAT	CACTGTTCCATATAT	2	1
TCGCAACGCTCCATT	TCGCAACGCTCCATT	2	1
TAAATCCGCACTGGA	TAAATCCGCACTGGA	3	1
TAAAAGTATTATTCA	TAAAAGTATTATTCA	1	1
TATATGATATAGTAT	TATATGATATAGTAT	1	1
ATACGTATCTAACCA	ATACGTATCTAACCA	1	1
TTCCTTAACACGATG	TTCCTTAACACGATG	3	1
GCGATTGAATTCTAT	GCGATTGAATTCTAT	2	1
TATAGTGACTGCGTC	TATAGTGACTGCGTC	1	1
GAATTAGCACGTTAC	GAATTAGCACGTTAC	1	1
ATTTGAGACATATTA	ATTTGAGACATATTA	1	1
TGGATTTCTACTCGG	TGGATTTCTACTCGG	17	1
AGTGGGTACCCACTT	AGTGGGTACCCACTT	1	1
GCTTGGGCGACAACT	GCTTGGGCGACAACT	1	1
AGGGTGATACATGGA	AGGGTGATACATGGA	1	1
TAAATCTAACTCCCT	TAAATCTAACTCCCT	2	1
GAGCGAACAAATTCT	GAGCGAACAAATTCT	3	1
CCGGTAACCCCTTTT	CCGGTAACCCCTTTT	1	1
ACGTATGTGCGTGCT	ACGTATGTGCGTGCT	3	1
GGAATCATTTTGTGT	GGAATCATTTTGTGT	5	1
TACCGGTTAGTAGCG	TACCGGTTAGTAGCG	7	1
TACGCTAACTTTTTA	TACGCTAACTTTTTA	2	1
TCTGGGGTGTTGAGT	TCTGGGGTGTTGAGT	2	1
GGAAATTAAGGCGCA	GGAAATTAAGGCGCA	2	1
CATGTCTGCACGGGA	CATGTCTGCACGGGA	2	1
TGTATTTCTTCGTAA	TGTATTTCTTCGTAA	1	1
TACGAGGTGGATAGT	TACGAGGTGGATAGT	4	1
AGCCATTTGTCAATC	AGCCATTTGTCAATC	4	1
ATAGGGTTGGTTCGG	ATAGGGTTGGTTCGG	1	1
GCGGGGGGCGGGGGT	GCGGGGGGCGGGGGT	1	1
GACAAGGGTTTTCAA	GACAAGGGTTTTCAA	1	1
GTGGGTGGGGTGACG	GTGGGTGGGGTGACG	1	1
TACGCTGCGTGATCT	TACGCTGCGTGATCT	2	1
GCCAATTATGGGCGG	GCCAATTATGGGCGG	1	1
TAAGTCCGGATTTTC	TAAGTCCGGATTTTC	1	1
TCCATAGTTAAGTTG	TCCATAGTTAAGTTG	1	1
GATCGTTGAGCTTCT	GATCGTTGAGCTTCT	1	1
CGAATATCGCCTGCA	CGAATATCGCCTGCA	1	1
GATACTTAAACCGAT	GATACTTAAACCGAT	1	1
GAATGTATAAAGGTT	GAATGTATAAAGGTT	2	1
GTTTTCCCTTAAGGT	GTTTTCCCTTAAGGT	2	1
CCCAAAGATTCATTT	CCCAAAGATTCATTT	1	1
GGGGTCCTGGGAGCG	GGGGTCCTGGGAGCG	1	1
GTGGAGAGGCAGGTG	GTGGAGAGGCAGGTG	2	1
GTTGGTGTGGCCGAG	GTTGGTGTGGCCGAG	1	1
GAACTCACGACGACG	GAACTCACGACGACG	5	1
ATTTTTACTATTAAA	ATTTTTACTATTAAA	1	1
GTATCCGGCCAGACG	GTATCCGGCCAGACG	1	1
TAATCCCAACGCCTT	TAATCCCAACGCCTT	1	1
ATGGTAAGTGGTGGT	ATGGTAAGTGGTGGT	3	1
AAGACGGTTGTCTCT	AAGACGGTTGTCTCT	1	1
CTGAGGCGCAAGTCA	CTGAGGCGCAAGTCA	1	1
TACTAGATCCCTCTT	TACTAGATCCCTCTT	1	1
AATTAAACTCTTTGT	AATTAAACTCTTTGT	1	1
AGACCTTTCCTAGTT	AGACCTTTCCTAGTT	1	1
TATATCGCGGTTAAT	TATATCGCGGTTAAT	3	1
CCACTGTCATTGGAA	CCACTGTCATTGGAA	2	1
CCAGATTTCGGGCGG	CCAGATTTCGGGCGG	1	1
AACGCGACTGGTCGA	AACGCGACTGGTCGA	5	1
TCTTTCGAATTCTCT	TCTTTCGAATTCTCT	2	1
GATATCAGTAACCTC	GATATCAGTAACCTC	1	1
ATCAGCATGTCATTA	ATCAGCATGTCATTA	3	1
GGGATTGGTCTGAAT	GGGATTGGTCTGAAT	4	1
GGCGTGGAGCTGCTT	GGCGTGGAGCTGCTT	2	1
TTTAAAGAACGTCAC	TTTAAAGAACGTCAC	2	1
GAAAGGCACATAGAA	GAAAGGCACATAGAA	1	1
CTTACATAATTCGTC	CTTACATAATTCGTC	4	1
TTTCACGACCCTGCT	TTTCACGACCCTGCT	3	1
CTTAACAGGGGTAAA	CTTAACAGGGGTAAA	1	1
GGATGGGTCTCGGGA	GGATGGGTCTCGGGA	2	1
GCTGCTAGAGGATCT	GCTGCTAGAGGATCT	2	1
TTATGTTAGTCCTAA	TTATGTTAGTCCTAA	7	1
GTACCAAGTTAGAGG	GTACCAAGTTAGAGG	1	1
ACCGGGGCTGCTGGG	ACCGGGGCTGCTGGG	6	1
AGTGTGTCGCATCTT	AGTGTGTCGCATCTT	1	1
CTAGTTAAGACTTAT	CTAGTTAAGACTTAT	1	1
ACGAGCGGTTTTCTA	ACGAGCGGTTTTCTA	1	1
TCTATGGAGAAACCA	TCTATGGAGAAACCA	1	1
TGATTGCATTTATTC	TGATTGCATTTATTC	1	1
GAGTCGTAAATACTA	GAGTCGTAAATACTA	1	1
TTTCCATATCTTCTT	TTTCCATATCTTCTT	3	1
ATTCCATAAATAATC	ATTCCATAAATAATC	3	1
ATATCACTTCCTGGT	ATATCACTTCCTGGT	2	1
CACAACAAAATACCC	CACAACAAAATACCC	1	1
CATAGTCTTTACGTG	CATAGTCTTTACGTG	4	1
ATAATCTACTTATCG	ATAATCTACTTATCG	2	1
CGCGTTAGGGTGTGT	CGCGTTAGGGTGTGT	5	1
TTAAGCATCACTGTA	TTAAGCATCACTGTA	2	1
TACGGGTGGGGTTTC	TACGGGTGGGGTTTC	2	1
AGGCCGTCATACCGC	AGGCCGTCATACCGC	2	1
GAGGTGGAGGGTAGG	GAGGTGGAGGGTAGG	2	1
GTTCCGAACTTAAGA	GTTCCGAACTTAAGA	2	1
TGTCGATGAGAAACG	TGTCGATGAGAAACG	1	1
CGATAGACAGAGGGA	CGATAGACAGAGGGA	3	1
TCTGTTGTGTTTAAT	TCTGTTGTGTTTAAT	2	1
TACACAAATAGAATT	TACACAAATAGAATT	2	1
GATAATGAAATTCTG	GATAATGAAATTCTG	2	1
TACCTTTCGATAGAA	TACCTTTCGATAGAA	2	1
TGGTGATAGTATGTA	TGGTGATAGTATGTA	1	1
TGTGTTAACGGGCTA	TGTGTTAACGGGCTA	1	1
ATGGTATTATTTACT	ATGGTATTATTTACT	1	1
CTTGAAAGGCATGTT	CTTGAAAGGCATGTT	1	1
GGGATGTTGAACGCG	GGGATGTTGAACGCG	2	1
TTTCTTAGGTAAGAG	TTTCTTAGGTAAGAG	2	1
ATATTGCATGGGTCA	ATATTGCATGGGTCA	1	1
GTTTTGATACATTAG	GTTTTGATACATTAG	2	1
AATTTCCATGATGCA	AATTTCCATGATGCA	1	1
TGTTATATCTTCTTT	TGTTATATCTTCTTT	1	1
GTACCGGACTCTCTG	GTACCGGACTCTCTG	1	1
GACTCGTGGGTGTAT	GACTCGTGGGTGTAT	1	1
TAAGTAGACCTTTCA	TAAGTAGACCTTTCA	1	1
TTTAAACATTTCTTT	TTTAAACATTTCTTT	5	1
TATATCGACCCTTGA	TATATCGACCCTTGA	2	1
GTGTCATCTGCAGCA	GTGTCATCTGCAGCA	1	1
TAGTATGAATCCAAT	TAGTATGAATCCAAT	2	1
TACAATTTAGTAGAT	TACAATTTAGTAGAT	1	1
AGGCCGGCGGGCTGG	AGGCCGGCGGGCTGG	1	1
TTCCTTCCATAAACA	TTCCTTCCATAAACA	1	1
TCCGGTTACAAACCC	TCCGGTTACAAACCC	1	1
ATATAATCTTAAAAA	ATATAATCTTAAAAA	1	1
ATATGGCCTTCATAT	ATATGGCCTTCATAT	4	1
ATGTTGTCTGTATAG	ATGTTGTCTGTATAG	1	1
CACTAACTCGCCTCT	CACTAACTCGCCTCT	1	1
TAATGACTCTGTCTT	TAATGACTCTGTCTT	2	1
GACGCCGACACACTT	GACGCCGACACACTT	5	1
GCGCGGTTGGCGTAA	GCGCGGTTGGCGTAA	1	1
AAAATTGTACCTTCG	AAAATTGTACCTTCG	4	1
TTCCGTACGATCAAG	TTCCGTACGATCAAG	2	1
AAATGTGAATTCGTT	AAATGTGAATTCGTT	1	1
GCGGCTGTGCTCACG	GCGGCTGTGCTCACG	1	1
AATGTTTTATAGGTA	AATGTTTTATAGGTA	1	1
TTTGCATGCCACTCA	TTTGCATGCCACTCA	2	1
CATAGGAAATCGATG	CATAGGAAATCGATG	1	1
AAAGTAACCGCAATT	AAAGTAACCGCAATT	1	1
AAAGTTCCAACCATT	AAAGTTCCAACCATT	3	1
GTTTAAATTTGCCTG	GTTTAAATTTGCCTG	1	1
TATTTTAATTAGTTT	TATTTTAATTAGTTT	2	1
CTCTCTACTGGATCA	CTCTCTACTGGATCA	2	1
TTCTATTTACTCAGA	TTCTATTTACTCAGA	3	1
GGAAACGATTAGCAT	GGAAACGATTAGCAT	1	1
GTACACTCGTAGAAA	GTACACTCGTAGAAA	1	1
TTTGCCAAACATATA	TTTGCCAAACATATA	1	1
GTGGTTTTATAGTGA	GTGGTTTTATAGTGA	2	1
AGTTCAGAGTGGACG	AGTTCAGAGTGGACG	3	1
GACTATCGTGTATCA	GACTATCGTGTATCA	1	1
AATATCGCACTCGTT	AATATCGCACTCGTT	2	1
GAAGGTATGGACGTT	GAAGGTATGGACGTT	1	1
CCAGGGGCAGGCGGT	CCAGGGGCAGGCGGT	1	1
AGTTTGTTCTTGCAT	AGTTTGTTCTTGCAT	1	1
GGTGCTTGTGCTTGG	GGTGCTTGTGCTTGG	1	1
TTATTTAACTGAAAT	TTATTTAACTGAAAT	2	1
CACGCGTCTGTGATT	CACGCGTCTGTGATT	4	1
CGGACAGTGAATTTC	CGGACAGTGAATTTC	1	1
TGTTCGTATAAGTGG	TGTTCGTATAAGTGG	3	1
ATCATGATCGCGTTA	ATCATGATCGCGTTA	1	1
GTAGTGGGTTTTAAC	GTAGTGGGTTTTAAC	1	1
CAAATCCTGGCACAA	CAAATCCTGGCACAA	1	1
ATTCTTGAACGCTGC	ATTCTTGAACGCTGC	2	1
TTAGGCTGCTGCGAT	TTAGGCTGCTGCGAT	1	1
ATCAGTGACCCAGGA	ATCAGTGACCCAGGA	2	1
ATAGTATCTTTTTAG	ATAGTATCTTTTTAG	1	1
ACGTTTGTTCTACTA	ACGTTTGTTCTACTA	1	1
TTTGTTTCAGACTCT	TTTGTTTCAGACTCT	1	1
ATAGTTGGTTGTAGT	ATAGTTGGTTGTAGT	2	1
TAGTATCCGCATTAT	TAGTATCCGCATTAT	1	1
GTCCTATTTCAGTTA	GTCCTATTTCAGTTA	1	1
CCGAAGTATTGACTC	CCGAAGTATTGACTC	1	1
ATATCGTCTCTGACA	ATATCGTCTCTGACA	2	1
AAAGTATCCTGTCGT	AAAGTATCCTGTCGT	1	1
GACCATTAATCGCCG	GACCATTAATCGCCG	1	1
TAGTTCTCCTGCTAT	TAGTTCTCCTGCTAT	2	1
TGATCCATGACCAGG	TGATCCATGACCAGG	3	1
TTAATAAACTACCTT	TTAATAAACTACCTT	1	1
GTTAAAGGTAAATGG	GTTAAAGGTAAATGG	1	1
TAATTATGTTTATTT	TAATTATGTTTATTT	3	1
GGCCGCAGGAATTTT	GGCCGCAGGAATTTT	2	1
TCCGACGTATACATA	TCCGACGTATACATA	1	1
TAATACGGTATTCAA	TAATACGGTATTCAA	1	1
ATCGAAACTGCTTTT	ATCGAAACTGCTTTT	3	1
GCGGGCGGCGGCTTT	GCGGGCGGCGGCTTT	1	1
GTGCGACGGGGCAGG	GTGCGACGGGGCAGG	2	1
ATACCAATTTAATAG	ATACCAATTTAATAG	1	1
GATAGCATGTTGGAA	GATAGCATGTTGGAA	1	1
AGATCGCAGTGGCTT	AGATCGCAGTGGCTT	4	1
AGGGTTGCTTCTCTG	AGGGTTGCTTCTCTG	7	1
TAATGCCGGGTACGT	TAATGCCGGGTACGT	1	1
AATCATACTAGTCGG	AATCATACTAGTCGG	1	1
ATCATTTGGTATGTT	ATCATTTGGTATGTT	1	1
CTAAGCATTGGTGGG	CTAAGCATTGGTGGG	2	1
GGGGCGGGACGCGTA	GGGGCGGGACGCGTA	2	1
AGGAAGGCGGGCTTT	AGGAAGGCGGGCTTT	3	1
GTATAAGAGTTGGCT	GTATAAGAGTTGGCT	2	1
TTACATGTACTCAGG	TTACATGTACTCAGG	1	1
AAAAGATATTTAGTA	AAAAGATATTTAGTA	1	1
CGGACGCGGGGGCTG	CGGACGCGGGGGCTG	2	1
TATGTGTATGAACTT	TATGTGTATGAACTT	2	1
TAATGCTGCTCAACG	TAATGCTGCTCAACG	1	1
TACGAACGTCGCGAG	TACGAACGTCGCGAG	3	1
TTTTTAATGACGCCG	TTTTTAATGACGCCG	2	1
TGGTCTGGGTGGACT	TGGTCTGGGTGGACT	2	1
CCGTTGGTGGCTTTG	CCGTTGGTGGCTTTG	3	1
GAGTGTTCCGTCATC	GAGTGTTCCGTCATC	6	1
TTACATGCAGTTAAT	TTACATGCAGTTAAT	2	1
GCAGTTTAGCATATA	GCAGTTTAGCATATA	1	1
TGCGAAGTACCGAGG	TGCGAAGTACCGAGG	1	1
CAGAACTGGTTGTAA	CAGAACTGGTTGTAA	2	1
GGAGCAGTCGCGCCC	GGAGCAGTCGCGCCC	1	1
AGGTGAGCGCAATAG	AGGTGAGCGCAATAG	3	1
CAACGATATAAATCA	CAACGATATAAATCA	2	1
GCTCACGCAATGCAA	GCTCACGCAATGCAA	3	1
AAACGTCAGAAGCAT	AAACGTCAGAAGCAT	1	1
TTGATTATATTCATA	TTGATTATATTCATA	1	1
TCACCGATTCAACTC	TCACCGATTCAACTC	1	1
TTGGATGATTTCTTA	TTGGATGATTTCTTA	2	1
CTTATTTTGGGATAC	CTTATTTTGGGATAC	5	1
GTTAGCTGTAATGAT	GTTAGCTGTAATGAT	2	1
CTCGAGGGCCAGAAC	CTCGAGGGCCAGAAC	2	1
TTCAATTGGAGAGTG	TTCAATTGGAGAGTG	1	1
TTAGATCTGCATATA	TTAGATCTGCATATA	1	1
ATTCGGCATCAAGGA	ATTCGGCATCAAGGA	1	1
CAAAATTAGTTTGTG	CAAAATTAGTTTGTG	4	1
TCATGAGTTACTTTC	TCATGAGTTACTTTC	13	1
CATTGAGGTTCTCTA	CATTGAGGTTCTCTA	1	1
GTTAGCGTATGACGT	GTTAGCGTATGACGT	2	1
CCCGGGGCTGTTTCG	CCCGGGGCTGTTTCG	2	1
GCATAACCACTTTTC	GCATAACCACTTTTC	1	1
ATTTAGTATAAGGTA	ATTTAGTATAAGGTA	3	1
TGTGTGCGGCGCGTT	TGTGTGCGGCGCGTT	4	1
CTCCATAAGCAAACC	CTCCATAAGCAAACC	1	1
GACATTTGGGGCACT	GACATTTGGGGCACT	1	1
TGACCGAGAGTATCA	TGACCGAGAGTATCA	1	1
TTCTAATGTATATTT	TTCTAATGTATATTT	1	1
TCCTGAGCTTTCAGA	TCCTGAGCTTTCAGA	1	1
TTCTGTTCCAAAATT	TTCTGTTCCAAAATT	2	1
TTAAGTATCCCATAA	TTAAGTATCCCATAA	1	1
GGAGGGCGTAGGGAA	GGAGGGCGTAGGGAA	2	1
AGTGGCAGTCATATG	AGTGGCAGTCATATG	2	1
AACTTGTACTAGTTT	AACTTGTACTAGTTT	1	1
TTAGTGGCGTTATGC	TTAGTGGCGTTATGC	3	1
TCCCGTGGGTTTTTC	TCCCGTGGGTTTTTC	1	1
GTCTGATCAAACTTT	GTCTGATCAAACTTT	3	1
TCCATGGCCTACCGT	TCCATGGCCTACCGT	1	1
CCCCGCGTCTTCCCT	CCCCGCGTCTTCCCT	1	1
TATATCTCACGTGTG	TATATCTCACGTGTG	3	1
ATAGAAGCCTCCTAC	ATAGAAGCCTCCTAC	3	1
AGAAACGTCTAAAAG	AGAAACGTCTAAAAG	2	1
TGAATGAAGTGTTTG	TGAATGAAGTGTTTG	1	1
TTGCGTCTCAAATTT	TTGCGTCTCAAATTT	1	1
GTCAGACTGGTAGAG	GTCAGACTGGTAGAG	1	1
GCAAGAAGATAAAAG	GCAAGAAGATAAAAG	3	1
AACCAGCATCTGTAA	AACCAGCATCTGTAA	1	1
ACCAGTGTGCCCTCC	ACCAGTGTGCCCTCC	1	1
GCTAGGTGTGTTTAT	GCTAGGTGTGTTTAT	2	1
GGAGGCTGTGTGGTA	GGAGGCTGTGTGGTA	3	1
GCGTTGGCAGCAAAG	GCGTTGGCAGCAAAG	2	1
TATCGAATTAATGGG	TATCGAATTAATGGG	1	1
GTACTTGATGTTTTA	GTACTTGATGTTTTA	1	1
GAGTCCATTCTACGA	GAGTCCATTCTACGA	3	1
TGACGGAATACATTG	TGACGGAATACATTG	1	1
AAGTCGAACACTTTA	AAGTCGAACACTTTA	1	1
TTTCTATGAATAAAC	TTTCTATGAATAAAC	1	1
AGCGTCTTTGATCAC	AGCGTCTTTGATCAC	3	1
TCAGCGGGCGTACCA	TCAGCGGGCGTACCA	2	1
TGATAGCTAGATAAT	TGATAGCTAGATAAT	1	1
GTCGAACGGTAGGCG	GTCGAACGGTAGGCG	3	1
TTCTTCTAGGCTCAG	TTCTTCTAGGCTCAG	2	1
AGAGTGAGGATTGTT	AGAGTGAGGATTGTT	2	1
GTTCTTGCTTACCCG	GTTCTTGCTTACCCG	3	1
TATCGCAATTTCCAA	TATCGCAATTTCCAA	1	1
GGGAGTGTTTAGATG	GGGAGTGTTTAGATG	1	1
TGAAGCATTGATCTT	TGAAGCATTGATCTT	1	1
TAAATGATGGCGTCT	TAAATGATGGCGTCT	1	1
ACTCCCATTCGGATA	ACTCCCATTCGGATA	2	1
GTTAACTTTTGATGC	GTTAACTTTTGATGC	3	1
AGTGCAATAAGTTAG	AGTGCAATAAGTTAG	1	1
ATAGTCCCGATGTAG	ATAGTCCCGATGTAG	1	1
GCGTTCCCATTCAGA	GCGTTCCCATTCAGA	1	1
ACTTCCGAAATATTG	ACTTCCGAAATATTG	1	1
TCAAATATACTATAA	TCAAATATACTATAA	2	1
GCTAGATTAACCTTT	GCTAGATTAACCTTT	3	1
GCATCTTCGTCATGG	GCATCTTCGTCATGG	1	1
ATACCTGTATACGAG	ATACCTGTATACGAG	1	1
TACAGTAGAACGACT	TACAGTAGAACGACT	1	1
TTGGACTAAAATTAG	TTGGACTAAAATTAG	2	1
TTTACTCTGGATTTC	TTTACTCTGGATTTC	1	1
AACTTTCTAATTTTT	AACTTTCTAATTTTT	1	1
TGATTGGACATGGTT	TGATTGGACATGGTT	4	1
GTGATGCAATTTTTT	GTGATGCAATTTTTT	3	1
TTTGAATGAGCTTGC	TTTGAATGAGCTTGC	1	1
AAGCCGAATTCCTGT	AAGCCGAATTCCTGT	1	1
GGAAGCGAATCCTTA	GGAAGCGAATCCTTA	1	1
GGTGGGTTGCAGGTG	GGTGGGTTGCAGGTG	2	1
TCAGTGGTACATCAC	TCAGTGGTACATCAC	4	1
ATTATAGTTCCTCAT	ATTATAGTTCCTCAT	1	1
TCCTGTATTGTGCAG	TCCTGTATTGTGCAG	1	1
TTATATAACATTAGA	TTATATAACATTAGA	1	1
CGCGCACACGATCTT	CGCGCACACGATCTT	1	1
TCAGATTTCTTAAAC	TCAGATTTCTTAAAC	2	1
TGAACTGCTCCTTTA	TGAACTGCTCCTTTA	2	1
TACTATTGATGAATG	TACTATTGATGAATG	1	1
TCACCACACTTGAAA	TCACCACACTTGAAA	1	1
GCGGCGTGCGGCGAT	GCGGCGTGCGGCGAT	1	1
TTAGTACGGTCTCCT	TTAGTACGGTCTCCT	1	1
AATGTATGGAATGTA	AATGTATGGAATGTA	1	1
GACATCAGACTGTCG	GACATCAGACTGTCG	1	1
CAATGGTATCGCCCG	CAATGGTATCGCCCG	4	1
GGCATGTTGATGAGT	GGCATGTTGATGAGT	1	1
ATATGAATCGTTTCC	ATATGAATCGTTTCC	1	1
GCAGGCCGGGGGTGG	GCAGGCCGGGGGTGG	1	1
TATCATAGTTGAATT	TATCATAGTTGAATT	2	1
ACACACGTTTTATTT	ACACACGTTTTATTT	1	1
TGAGTTTGGGCGACA	TGAGTTTGGGCGACA	1	1
TATGGTAGGTTTTTG	TATGGTAGGTTTTTG	1	1
CTAACTCGTGTGGTA	CTAACTCGTGTGGTA	3	1
TGTCAACCGAATATT	TGTCAACCGAATATT	3	1
CAGTATTTATATAGT	CAGTATTTATATAGT	1	1
TAGCGTAAAGCATAC	TAGCGTAAAGCATAC	1	1
TATAGAGGTAAGCTA	TATAGAGGTAAGCTA	2	1
CAAGTTCGTGCCAAT	CAAGTTCGTGCCAAT	3	1
CCCCTAGGATCACTT	CCCCTAGGATCACTT	2	1
AATCAAAGTGTTTAC	AATCAAAGTGTTTAC	1	1
TTTGTTTCATACTCT	TTTGTTTCATACTCT	1	1
TGCTCTCTTTGTGTG	TGCTCTCTTTGTGTG	1	1
ATCTATGGGTTACTA	ATCTATGGGTTACTA	1	1
TAAGACGTACTGACT	TAAGACGTACTGACT	1	1
AGCGTTCCTGGTCCG	AGCGTTCCTGGTCCG	3	1
ATGTTGCCATAGATA	ATGTTGCCATAGATA	1	1
TGGTTACGGTTTTTA	TGGTTACGGTTTTTA	2	1
TGATATCTCTTCATG	TGATATCTCTTCATG	2	1
TGCCTATTCTAACTT	TGCCTATTCTAACTT	1	1
TGGTATAGCAATTCG	TGGTATAGCAATTCG	1	1
GCCTATACACATCGT	GCCTATACACATCGT	2	1
TGTATATGCCTTGGC	TGTATATGCCTTGGC	4	1
GGCAAATCGGTGTGT	GGCAAATCGGTGTGT	2	1
AATCTAAGGCTAATA	AATCTAAGGCTAATA	2	1
ATTTCTAAATTTGTT	ATTTCTAAATTTGTT	1	1
GTGCCGTAGATGTAT	GTGCCGTAGATGTAT	1	1
GAGAAAGGCTGTACA	GAGAAAGGCTGTACA	1	1
CTGAGAGCGAACGTC	CTGAGAGCGAACGTC	3	1
TCAAGGTATTTATTT	TCAAGGTATTTATTT	2	1
ATTATTCAGAAGTTT	ATTATTCAGAAGTTT	5	1
AGCTCTTTCACCTCA	AGCTCTTTCACCTCA	1	1
CGTAACACCCAATAT	CGTAACACCCAATAT	2	1
TGCGACTCGTAATCT	TGCGACTCGTAATCT	7	1
AGTTAATGGGATCTT	AGTTAATGGGATCTT	1	1
TCCAGCCTGCGGAAA	TCCAGCCTGCGGAAA	2	1
TGACTTTCTTTACGT	TGACTTTCTTTACGT	2	1
GTCTCTATTTCTTTC	GTCTCTATTTCTTTC	1	1
CTTGGCGGTGTCGAG	CTTGGCGGTGTCGAG	2	1
CAAATTGGAGAGCTT	CAAATTGGAGAGCTT	1	1
TTACTCCTCATAATT	TTACTCCTCATAATT	2	1
GTAGCAAAGATGCGT	GTAGCAAAGATGCGT	2	1
TCAGATTGGGAGCTG	TCAGATTGGGAGCTG	4	1
TTAAGTAGATAGTTT	TTAAGTAGATAGTTT	1	1
AATCTGCGAAATTAC	AATCTGCGAAATTAC	4	1
CACTCGGACAATACA	CACTCGGACAATACA	1	1
ATCGTGCCCTTATTG	ATCGTGCCCTTATTG	2	1
AAAGCTTTCAGGTTT	AAAGCTTTCAGGTTT	5	1
TTGCTTGTTCCATTT	TTGCTTGTTCCATTT	1	1
CCTACTAGAAAGGGA	CCTACTAGAAAGGGA	2	1
GGATCCCTGTTTTGA	GGATCCCTGTTTTGA	1	1
GTTTACAACTGTATA	GTTTACAACTGTATA	1	1
AGTTTTATATAACAT	AGTTTTATATAACAT	2	1
TGCTCTGTCGGTTAT	TGCTCTGTCGGTTAT	1	1
AATTTGTGCTATGTC	AATTTGTGCTATGTC	1	1
AATACCATTATATAT	AATACCATTATATAT	1	1
CAGTTAGGGTTTCTC	CAGTTAGGGTTTCTC	2	1
GCGCACATGCGGTGT	GCGCACATGCGGTGT	1	1
CTACGGGCAATGAGT	CTACGGGCAATGAGT	1	1
AGAAGTTCACACTCA	AGAAGTTCACACTCA	1	1
CGGGAGCGGGGCTCG	CGGGAGCGGGGCTCG	1	1
ACATGCGTTAACATT	ACATGCGTTAACATT	2	1
GTTTTACGTATCTTA	GTTTTACGTATCTTA	1	1
TGTGTACGTCTTTAT	TGTGTACGTCTTTAT	1	1
GGTGGTAACGCTACT	GGTGGTAACGCTACT	2	1
TGAAGTTTGAGGTTT	TGAAGTTTGAGGTTT	1	1
AACTATTCACATTCA	AACTATTCACATTCA	3	1
TTCATCAGACGTGTA	TTCATCAGACGTGTA	1	1
ATTACACGGTTATAT	ATTACACGGTTATAT	3	1
CGTCATTGCGGGATA	CGTCATTGCGGGATA	1	1
AATGAGGTACGCAGT	AATGAGGTACGCAGT	3	1
ACCTGTAGATTTTCT	ACCTGTAGATTTTCT	1	1
AATAACGTTCCACAC	AATAACGTTCCACAC	1	1
GGCAGTTAGACACCT	GGCAGTTAGACACCT	1	1
TGAAGAAACCATAAT	TGAAGAAACCATAAT	1	1
ACAGTCTTGTATTAT	ACAGTCTTGTATTAT	1	1
TTTCATAATGATCTT	TTTCATAATGATCTT	2	1
ATCTCCCACATTGCA	ATCTCCCACATTGCA	1	1
CCATATCAATGATAG	CCATATCAATGATAG	1	1
TGTGGGGGAAAAGTG	TGTGGGGGAAAAGTG	3	1
GAAAGCGGTTTCAAT	GAAAGCGGTTTCAAT	1	1
TTAAACAATAGTTTA	TTAAACAATAGTTTA	7	1
ACTTTATATCCAAGG	ACTTTATATCCAAGG	1	1
GCCTTTGATCCAATC	GCCTTTGATCCAATC	2	1
TGTAGAGTCTCCTCA	TGTAGAGTCTCCTCA	1	1
ATCTTTTAGAGCCAA	ATCTTTTAGAGCCAA	2	1
CTCTCTCTAGTATAT	CTCTCTCTAGTATAT	1	1
ATTGTATACTTGATA	ATTGTATACTTGATA	1	1
TCAAGACGACTCTTC	TCAAGACGACTCTTC	3	1
TACGCTTCCCTATTC	TACGCTTCCCTATTC	1	1
TAATGAAAGTCACTT	TAATGAAAGTCACTT	2	1
GGTTGTGGCCGGTGG	GGTTGTGGCCGGTGG	1	1
TGTGTAGCCATGATT	TGTGTAGCCATGATT	1	1
TGCATGGCTGTGTTT	TGCATGGCTGTGTTT	2	1
CTGAGTTATTTTGCT	CTGAGTTATTTTGCT	3	2
ATCACATAGCTAACG	ATCACATAGCTAACG	4	1
GGTGTGGTAGGGGGT	GGTGTGGTAGGGGGT	1	1
CACGATGATGCAAGT	CACGATGATGCAAGT	1	1
GATTGTAAACATGCG	GATTGTAAACATGCG	2	1
TGGTACTTTAAACGC	TGGTACTTTAAACGC	1	1
ACATCGTTAGTTATT	ACATCGTTAGTTATT	1	1
CACAGAATACGCGAT	CACAGAATACGCGAT	1	1
GGATATTCTCGAGAT	GGATATTCTCGAGAT	2	1
TTGTCAGTCCTCCTT	TTGTCAGTCCTCCTT	1	1
GAAGATTTCGCAGTC	GAAGATTTCGCAGTC	3	1
CTTTCAATTATTATT	CTTTCAATTATTATT	1	1
TGCCGTAAGCCAACT	TGCCGTAAGCCAACT	2	1
GTAAGTACTCGTGCG	GTAAGTACTCGTGCG	1	1
GGTTCGGGGGGGAGG	GGTTCGGGGGGGAGG	1	1
GGTTGGTTGTGCAAA	GGTTGGTTGTGCAAA	1	1
GGATATATTATAATT	GGATATATTATAATT	1	1
AGAGCAGGTTCTTTA	AGAGCAGGTTCTTTA	1	1
TCGGTAACTATATCT	TCGGTAACTATATCT	1	1
GATAGTAAGTACTCT	GATAGTAAGTACTCT	2	1
TTCCAATATTGGTAT	TTCCAATATTGGTAT	2	1
TGCGGTTACGATTTA	TGCGGTTACGATTTA	1	1
TTGTGTCCGGGAGGG	TTGTGTCCGGGAGGG	1	1
ATTTCCTACCTGACG	ATTTCCTACCTGACG	1	1
GGTTGACGAGTAAGA	GGTTGACGAGTAAGA	1	1
AGACAGACCTCGGGT	AGACAGACCTCGGGT	1	1
GTAATCTGTCCTTTT	GTAATCTGTCCTTTT	1	1
CCGCGGGGCGGAGGG	CCGCGGGGCGGAGGG	2	1
GTGTTGATGTGCTCA	GTGTTGATGTGCTCA	2	1
ACCCAATCCGTCATG	ACCCAATCCGTCATG	1	1
TTATGTCATAGGTTG	TTATGTCATAGGTTG	1	1
TTCAAAGTCCCTGTC	TTCAAAGTCCCTGTC	2	1
CGATTTTACATTGGA	CGATTTTACATTGGA	2	1
TGAGACGTGATCGCA	TGAGACGTGATCGCA	1	1
CGTAGCCTTCTTTCG	CGTAGCCTTCTTTCG	3	1
CGCGCCGCTGAAGTG	CGCGCCGCTGAAGTG	1	1
ATGCACTGCGGGGGT	ATGCACTGCGGGGGT	1	1
CGATGAATGTGTACA	CGATGAATGTGTACA	1	1
CAGTTCATCCATGAG	CAGTTCATCCATGAG	2	1
TAAGAAAACCATTGT	TAAGAAAACCATTGT	3	1
TAGTGGTTCTTGGCT	TAGTGGTTCTTGGCT	2	1
TTTAAGGTTTGTGGC	TTTAAGGTTTGTGGC	1	1
ACTCACTAACTGCTA	ACTCACTAACTGCTA	1	1
AAAGAGTAAAAAACG	AAAGAGTAAAAAACG	1	1
ACCACGTCTCTGTAA	ACCACGTCTCTGTAA	1	1
TTTCTTATTGCTGCT	TTTCTTATTGCTGCT	2	1
AAGCGTTATACTATC	AAGCGTTATACTATC	1	1
AGTGCACAACTAGGG	AGTGCACAACTAGGG	1	1
GCAGATCCTGTCTTA	GCAGATCCTGTCTTA	1	1
GAAACCGAAAGCCTG	GAAACCGAAAGCCTG	1	1
CGGTTCCCATACGAT	CGGTTCCCATACGAT	2	1
CCTATTGGAGTCGGG	CCTATTGGAGTCGGG	2	1
AATTCATTCCATTAA	AATTCATTCCATTAA	1	1
TTTATTAAAGTGCTC	TTTATTAAAGTGCTC	3	1
TTCCTATGCATTCGT	TTCCTATGCATTCGT	1	1
TTGATAATTGGTTTT	TTGATAATTGGTTTT	1	1
TTCTCTCGTAAAGGG	TTCTCTCGTAAAGGG	1	1
TGTCGTGCGCGCTCT	TGTCGTGCGCGCTCT	1	1
TTTCCAGGGTAAACT	TTTCCAGGGTAAACT	1	1
GGCATGGAGTGGGTA	GGCATGGAGTGGGTA	1	1
TATACATCAACCCAA	TATACATCAACCCAA	1	1
GCTTGTAATCTTCCC	GCTTGTAATCTTCCC	1	1
ATCATACAATACCAG	ATCATACAATACCAG	3	1
TGGTGGTACGCGATG	TGGTGGTACGCGATG	1	1
CGGTTGATCTCGGTA	CGGTTGATCTCGGTA	2	1
TGCAGTTCTGTGATA	TGCAGTTCTGTGATA	2	1
GTCGTTATACCTGAT	GTCGTTATACCTGAT	1	1
TTACTAGTAACACTA	TTACTAGTAACACTA	2	1
CCGTTGGCTAGTTTG	CCGTTGGCTAGTTTG	1	1
TAGAACTACATTTCA	TAGAACTACATTTCA	3	1
TGGATCTACTGCAAT	TGGATCTACTGCAAT	1	1
GTGGAGAGCCTTGGG	GTGGAGAGCCTTGGG	2	1
GAAGCCACATTATGT	GAAGCCACATTATGT	3	1
GATCCCAGGCTTATA	GATCCCAGGCTTATA	2	1
TTTTGATAAGTAGGC	TTTTGATAAGTAGGC	2	1
GCATGGGCGAAGTGG	GCATGGGCGAAGTGG	2	1
ATTTTCGAAATGAGA	ATTTTCGAAATGAGA	1	1
TACCTATCGTCTCTG	TACCTATCGTCTCTG	1	1
ATTCAAAGGCAACTG	ATTCAAAGGCAACTG	1	1
GGGTGTCGGGTAAAT	GGGTGTCGGGTAAAT	3	1
ATCTGGGTTCAGCTG	ATCTGGGTTCAGCTG	1	1
AAAAGGTTCCAAACA	AAAAGGTTCCAAACA	1	1
CGAAAAACCCGCGTT	CGAAAAACCCGCGTT	1	1
TCCACCGTAATGTTG	TCCACCGTAATGTTG	1	1
TTATTCTATAAATGA	TTATTCTATAAATGA	1	1
AACGTATTCTACCGG	AACGTATTCTACCGG	1	1
CAAGTTTCCTCATTT	CAAGTTTCCTCATTT	3	1
ATTTTTATTCTACAG	ATTTTTATTCTACAG	1	1
CAAAGCGGAGTCTGA	CAAAGCGGAGTCTGA	2	1
GTTTGCGAGTTGCTA	GTTTGCGAGTTGCTA	1	1
TAAAAAAGCCATACT	TAAAAAAGCCATACT	1	1
TCTAGCCTTCTTACC	TCTAGCCTTCTTACC	1	1
TGTATTCATCTATAA	TGTATTCATCTATAA	2	1
ATGAGTATTAACCCA	ATGAGTATTAACCCA	3	1
ATTGATCGTGGACTA	ATTGATCGTGGACTA	2	1
GAACTGTATTAGTAA	GAACTGTATTAGTAA	1	1
GCGGATGAACTCTTC	GCGGATGAACTCTTC	1	1
CATGACTTCTAATTT	CATGACTTCTAATTT	1	1
GGATATGCATCTGAT	GGATATGCATCTGAT	1	1
GTCTATGCTTAAAGA	GTCTATGCTTAAAGA	1	1
CGTGCTCCCACATGC	CGTGCTCCCACATGC	1	1
GTACGCATTCTATTC	GTACGCATTCTATTC	1	1
TATAGACGAGTATTT	TATAGACGAGTATTT	1	1
AGAGCTAACATGTAT	AGAGCTAACATGTAT	1	1
TTTAGAATGATTGTA	TTTAGAATGATTGTA	2	1
TGCATTGAAAATGCA	TGCATTGAAAATGCA	1	1
CATTTACGTGTAAAA	CATTTACGTGTAAAA	5	1
TATAGGGTGTGCGTA	TATAGGGTGTGCGTA	1	1
ACAAGGTGTGTAGTT	ACAAGGTGTGTAGTT	2	1
ACTAATTGGTTACGT	ACTAATTGGTTACGT	2	1
CTACTTATCTTCATT	CTACTTATCTTCATT	1	1
CAGGCAGCAAAAATT	CAGGCAGCAAAAATT	1	1
AGTTGCACCATAACT	AGTTGCACCATAACT	2	1
ATCTGTTTCTCAAAA	ATCTGTTTCTCAAAA	1	1
TTCGTATGCTATTTC	TTCGTATGCTATTTC	4	1
ACATAGATCAGTCAT	ACATAGATCAGTCAT	1	1
TCCAGGATGGAGTCG	TCCAGGATGGAGTCG	1	1
CGTCCGGAAAATTGT	CGTCCGGAAAATTGT	2	1
ACACTGGGGTTACTT	ACACTGGGGTTACTT	2	1
GAGAAAATGAAATTG	GAGAAAATGAAATTG	2	1
TTGGTTTCTCTTAAG	TTGGTTTCTCTTAAG	1	1
CTTGATTAACGGTTG	CTTGATTAACGGTTG	3	1
GAGGGAGCGGATGGG	GAGGGAGCGGATGGG	1	1
ATTGCCCGTTCATCT	ATTGCCCGTTCATCT	2	1
TCCGTTTGGTACCCG	TCCGTTTGGTACCCG	2	1
TTCAAAATGCTCCTC	TTCAAAATGCTCCTC	3	1
ATCGACGCTTCGATG	ATCGACGCTTCGATG	2	1
TATACTACATACCCC	TATACTACATACCCC	1	1
CACATGTCGAATTCA	CACATGTCGAATTCA	1	1
TTTGTCAGCATAAGT	TTTGTCAGCATAAGT	1	1
AACCATCTCAGAAGG	AACCATCTCAGAAGG	3	1
ACCATATGATACTCC	ACCATATGATACTCC	2	1
GAACACTTAAGAGAT	GAACACTTAAGAGAT	2	1
GTTTGTAGTCCGCTC	GTTTGTAGTCCGCTC	2	1
CCACGGTAGGAATAA	CCACGGTAGGAATAA	1	1
CGAGTGTTACAGTGT	CGAGTGTTACAGTGT	3	1
GATTGATCAGTTCAA	GATTGATCAGTTCAA	1	1
GGATCACGGCGTCAT	GGATCACGGCGTCAT	1	1
TTCTACACTCACGGA	TTCTACACTCACGGA	1	1
TCTGGTTCCACATTT	TCTGGTTCCACATTT	3	1
GGCGCGGCGTGGGAG	GGCGCGGCGTGGGAG	1	1
TTCAGCCAGAGTCCT	TTCAGCCAGAGTCCT	1	1
ATCCTAGCGCTAACT	ATCCTAGCGCTAACT	1	1
ACGATGCGGCTGTTC	ACGATGCGGCTGTTC	4	1
AGATTGTCTGGTCTG	AGATTGTCTGGTCTG	1	1
CGTCAAGGTAGATTG	CGTCAAGGTAGATTG	1	1
AAGATGACGAAAGTT	AAGATGACGAAAGTT	3	1
GCGAAAGCTCATTCA	GCGAAAGCTCATTCA	1	1
GTGTTGGGGCTATTG	GTGTTGGGGCTATTG	2	1
CGTCACAATTCTACC	CGTCACAATTCTACC	1	1
GCTTACGTATACGTG	GCTTACGTATACGTG	3	1
AAAGTAGGGAGGGGG	AAAGTAGGGAGGGGG	1	1
TTAATCGTAATACCA	TTAATCGTAATACCA	1	1
CTTTTTGAAATGTGT	CTTTTTGAAATGTGT	1	1
ATCTCTCTTAGTCCT	ATCTCTCTTAGTCCT	1	1
TTCATAACAAACACT	TTCATAACAAACACT	2	1
CCCTTACGGAAGTTT	CCCTTACGGAAGTTT	1	1
TGTCTGCTCATGAGT	TGTCTGCTCATGAGT	2	1
TTTGGCTAACCGTCA	TTTGGCTAACCGTCA	1	1
TGCATTGGCACCTCC	TGCATTGGCACCTCC	1	1
GTAAACATAGAGTGC	GTAAACATAGAGTGC	1	1
CTTCTATGTGAGATC	CTTCTATGTGAGATC	1	1
TTTACCATATCCTTC	TTTACCATATCCTTC	2	1
ATAAACAACGGTGTG	ATAAACAACGGTGTG	2	1
CTGTTGGATGCGGGT	CTGTTGGATGCGGGT	3	1
AACAGGGTTATAGAC	AACAGGGTTATAGAC	1	1
TGAGTCTGAGCTTAC	TGAGTCTGAGCTTAC	1	1
ATAATTAAGAACTCT	ATAATTAAGAACTCT	2	1
ACCTATGGGACTGCT	ACCTATGGGACTGCT	4	1
GTCGCTGGTTAGGCG	GTCGCTGGTTAGGCG	2	1
ACTTAATACCACCCT	ACTTAATACCACCCT	1	1
GCGTGGCTGGAATGG	GCGTGGCTGGAATGG	1	1
TAATTTTTGTTTTAG	TAATTTTTGTTTTAG	1	1
AAATAATTCCTTGCT	AAATAATTCCTTGCT	2	1
CGACTAGTTTCTTCT	CGACTAGTTTCTTCT	2	1
CTAACTTAATACGAA	CTAACTTAATACGAA	2	1
ATTATGCATGGACTG	ATTATGCATGGACTG	1	1
GGTTTTTCCTCGAGA	GGTTTTTCCTCGAGA	4	1
TCAAGCCGATTGGCA	TCAAGCCGATTGGCA	2	1
GCGTGAAGAGCTGGG	GCGTGAAGAGCTGGG	2	1
GTTGCCTTCACTTTC	GTTGCCTTCACTTTC	1	1
GGCTCAAACAAATAC	GGCTCAAACAAATAC	1	1
ACTGAGCGATTTATG	ACTGAGCGATTTATG	3	1
GGGCCGAAAGTGGGG	GGGCCGAAAGTGGGG	1	1
CCAATAGGCTCGAAA	CCAATAGGCTCGAAA	2	1
ATGGATGGCATGTCA	ATGGATGGCATGTCA	1	1
TCAATCGGGGCAATC	TCAATCGGGGCAATC	1	1
TTAGCCGTCTTTTTA	TTAGCCGTCTTTTTA	1	1
CGAACGGGGAGTGTA	CGAACGGGGAGTGTA	1	1
GTGTCACTTGCACAC	GTGTCACTTGCACAC	1	1
GGACAGGACCCGTAC	GGACAGGACCCGTAC	5	1
TCCGCTTTTTATCCT	TCCGCTTTTTATCCT	2	1
ACGAGGGGATTCCTA	ACGAGGGGATTCCTA	3	1
AATCTATTGCGTGGG	AATCTATTGCGTGGG	1	1
GTTGCCAACTGTTAA	GTTGCCAACTGTTAA	3	1
CGAATATAAGAATGG	CGAATATAAGAATGG	1	1
CTAACTTTCCGTGTT	CTAACTTTCCGTGTT	2	1
GTTATGGCTCTTGTA	GTTATGGCTCTTGTA	1	1
GTTTTAATTTCTAGA	GTTTTAATTTCTAGA	1	1
GTGAGGAGGCATAGA	GTGAGGAGGCATAGA	1	1
GTTTACGGCCATCTT	GTTTACGGCCATCTT	2	1
GAAAATGCTCACTCT	GAAAATGCTCACTCT	5	1
GTAAAAGAAATAATT	GTAAAAGAAATAATT	1	1
TGCAATTCTCGCATA	TGCAATTCTCGCATA	1	1
TTTTAGCCAATGGCA	TTTTAGCCAATGGCA	1	1
GAAATCGTATAAACT	GAAATCGTATAAACT	3	1
CATACCGCATTTTTC	CATACCGCATTTTTC	2	1
CTCTTGATATGCTGT	CTCTTGATATGCTGT	2	1
CATGTGGTAGCCGTA	CATGTGGTAGCCGTA	2	1
CATACCGGGAAACAA	CATACCGGGAAACAA	3	1
ACACACGTTTTATTG	ACACACGTTTTATTG	2	1
TTTGTGGATTCTTTC	TTTGTGGATTCTTTC	3	1
CATTATCATTCTTGT	CATTATCATTCTTGT	1	1
GTGCCTATTGGGGGT	GTGCCTATTGGGGGT	2	1
TAGACTGTGTCTTCA	TAGACTGTGTCTTCA	1	1
CATGGGTGGGCTACT	CATGGGTGGGCTACT	1	1
GTACTTAATACTAAC	GTACTTAATACTAAC	1	1
GGTACAGACGAGTCA	GGTACAGACGAGTCA	6	1
TATAGATATCTAACC	TATAGATATCTAACC	1	1
TTATGCGAGCAATCG	TTATGCGAGCAATCG	1	1
CAGGGAGGGATGTTT	CAGGGAGGGATGTTT	1	1
TCCTTAAGCATCTAA	TCCTTAAGCATCTAA	1	1
TTCTTCCTTTAAGTT	TTCTTCCTTTAAGTT	2	1
ATTTTAACTCTGTTT	ATTTTAACTCTGTTT	1	1
GTCGGGGGTGTGGTG	GTCGGGGGTGTGGTG	2	1
ACGAAAGCTAAGGGG	ACGAAAGCTAAGGGG	1	1
AAAGTAGGGTATTAT	AAAGTAGGGTATTAT	1	1
AGCCTGATTGCATTT	AGCCTGATTGCATTT	1	1
TTACGGGCAGTTTTT	TTACGGGCAGTTTTT	1	1
TCATGAGTGGATATT	TCATGAGTGGATATT	4	1
ATCCGGTATTGATCC	ATCCGGTATTGATCC	3	1
TCCTGCACATTTAAT	TCCTGCACATTTAAT	3	1
ATGTGGCTTTAGCAA	ATGTGGCTTTAGCAA	1	1
GTTCGGCTCCCGTTC	GTTCGGCTCCCGTTC	2	1
TGCCGTGCCACCTGG	TGCCGTGCCACCTGG	1	1
GGGTCGGGTCTGTTG	GGGTCGGGTCTGTTG	1	1
GGGAGCGAAGGGGTA	GGGAGCGAAGGGGTA	2	1
GGGCGAGGGGGGAGG	GGGCGAGGGGGGAGG	1	1
CTTACAAGGCAGGTT	CTTACAAGGCAGGTT	2	1
ACATCTTACTACAAT	ACATCTTACTACAAT	2	1
GTTAGAATGGAGGTA	GTTAGAATGGAGGTA	1	1
ACTTTCAATCAGGGT	ACTTTCAATCAGGGT	1	1
CTAGGATTTAAAATG	CTAGGATTTAAAATG	1	1
CTGGGTGTTTTGTTT	CTGGGTGTTTTGTTT	2	1
TTAGAGTGAACTAAT	TTAGAGTGAACTAAT	2	1
GAGTGCGTTCATGTT	GAGTGCGTTCATGTT	1	1
TCAAACGAAGTGCCT	TCAAACGAAGTGCCT	1	1
GAATGGATTGCGACT	GAATGGATTGCGACT	1	1
GGGGTAGGGCCGGAT	GGGGTAGGGCCGGAT	1	1
TATTATCCCTAGCAT	TATTATCCCTAGCAT	2	1
CTCGGGGGATAGTTG	CTCGGGGGATAGTTG	1	1
GTTGGGCTATTCCGG	GTTGGGCTATTCCGG	1	1
TGAAAACTACCTGTG	TGAAAACTACCTGTG	1	1
GTTATGTCGCTATCT	GTTATGTCGCTATCT	2	1
GAATATCTAAATTGT	GAATATCTAAATTGT	2	1
AGAACCGCTAAAGCT	AGAACCGCTAAAGCT	2	1
ACCACACATTCTCAA	ACCACACATTCTCAA	2	1
GGGGGCGAGCAGTAA	GGGGGCGAGCAGTAA	2	1
ATCTTGAGGTCTTAA	ATCTTGAGGTCTTAA	1	1
CTAGATTTCCGTTAA	CTAGATTTCCGTTAA	1	1
TGTATCGTTACCTCA	TGTATCGTTACCTCA	1	1
ATACTATAGGAACGC	ATACTATAGGAACGC	2	1
CCATCTACACCCTAG	CCATCTACACCCTAG	2	1
TAAGTGATATTGATG	TAAGTGATATTGATG	4	1
GCGAGGGTCAGCTAT	GCGAGGGTCAGCTAT	1	1
TGATTGACTGCTTTG	TGATTGACTGCTTTG	5	1
TTTATATTAATCACC	TTTATATTAATCACC	3	1
CATAACTTCGAGTTC	CATAACTTCGAGTTC	2	1
CCCTTTTAAAGACTG	CCCTTTTAAAGACTG	1	1
ATATGTGTGGTCGGG	ATATGTGTGGTCGGG	1	1
GGGATCTAGGCTGGG	GGGATCTAGGCTGGG	1	1
CTTCAGGTCAAATAA	CTTCAGGTCAAATAA	1	1
TGCAGGCGCGGGGTG	TGCAGGCGCGGGGTG	4	1
GGGGTATCGTAAGAT	GGGGTATCGTAAGAT	2	1
CATTTAGTGCATTAT	CATTTAGTGCATTAT	1	1
ATTACGTCTCTTATC	ATTACGTCTCTTATC	2	1
AGGGAGATATCCATG	AGGGAGATATCCATG	1	1
TAATGAATCATAGAG	TAATGAATCATAGAG	1	1
TGGTTAAGGTTAATT	TGGTTAAGGTTAATT	1	1
TTCACATCGGCTTTG	TTCACATCGGCTTTG	2	1
TGACCTTGAGTGTTG	TGACCTTGAGTGTTG	3	1
CAAACATGTTGCGCA	CAAACATGTTGCGCA	1	1
CGTAATGGTGCTTTT	CGTAATGGTGCTTTT	1	1
TTAATCATGTATTAT	TTAATCATGTATTAT	2	1
AATTAGCGTATATGC	AATTAGCGTATATGC	1	1
TATAACATCTATACA	TATAACATCTATACA	1	1
ATTATGTTGAGAGCG	ATTATGTTGAGAGCG	1	1
GGGCGCCTGCTGTAT	GGGCGCCTGCTGTAT	1	1
TTAACAAAGATTTTT	TTAACAAAGATTTTT	2	1
TCATAAGTATAGATT	TCATAAGTATAGATT	2	1
CTACGAGATTCTACT	CTACGAGATTCTACT	2	1
TATGAGCAGGTGAGG	TATGAGCAGGTGAGG	2	1
GTTAGCCCGATGCAA	GTTAGCCCGATGCAA	1	1
TTTTGGAGTATTGCG	TTTTGGAGTATTGCG	1	1
ATTAGCATGTTATTA	ATTAGCATGTTATTA	1	1
GCTTTATCCGCTAGG	GCTTTATCCGCTAGG	2	1
CTCATAATGTCCGTG	CTCATAATGTCCGTG	1	1
CTTCTTTGGGGTGGG	CTTCTTTGGGGTGGG	1	1
TGTCAGATTTGTTAC	TGTCAGATTTGTTAC	2	1
TTTAGGGACCCGTCT	TTTAGGGACCCGTCT	2	1
TTTCACCAGCATCGT	TTTCACCAGCATCGT	1	1
TTTCGTGATACCTTT	TTTCGTGATACCTTT	2	1
CGAGTAGTTTAGAAT	CGAGTAGTTTAGAAT	1	1
ATAAATTATGTTTCT	ATAAATTATGTTTCT	4	1
TTGATTCTACTTAAT	TTGATTCTACTTAAT	1	1
ATCCTGCTCCTTCTG	ATCCTGCTCCTTCTG	3	1
CCATTCACTACTTTA	CCATTCACTACTTTA	1	1
AGTTAAAAACTTCAG	AGTTAAAAACTTCAG	1	1
TTTTAACGAACATTT	TTTTAACGAACATTT	1	1
ACCATGTGTATAGTC	ACCATGTGTATAGTC	1	1
TCTTGTAGGGAGGTA	TCTTGTAGGGAGGTA	3	1
TGTAACCGATGTATC	TGTAACCGATGTATC	4	1
GTCTGCTTGTCACTG	GTCTGCTTGTCACTG	2	1
TGCGTGGAGGGGGGG	TGCGTGGAGGGGGGG	2	1
TTTTACACCCTATGA	TTTTACACCCTATGA	1	1
CAAAAAGCTGCTAAT	CAAAAAGCTGCTAAT	1	1
GGTCGGTTGCTGTTT	GGTCGGTTGCTGTTT	3	1
GTAGAGTGTGCATGA	GTAGAGTGTGCATGA	1	1
TATGATACAGGTTTT	TATGATACAGGTTTT	2	1
CGATATGATGTGAAT	CGATATGATGTGAAT	1	1
ATTATGCCGTTATAC	ATTATGCCGTTATAC	3	1
CAGTTTCCATCACTA	CAGTTTCCATCACTA	1	1
ACTATTCTCGAGACT	ACTATTCTCGAGACT	1	1
TGAAGTCATTGCGCT	TGAAGTCATTGCGCT	1	1
GATGTTTCGTTTTAC	GATGTTTCGTTTTAC	1	1
TTCGAAACTCAAGCT	TTCGAAACTCAAGCT	1	1
TTTATCAGAAGGGCT	TTTATCAGAAGGGCT	1	1
ATCGGCATGGCACTA	ATCGGCATGGCACTA	2	1
TTAGGCGGAGATACT	TTAGGCGGAGATACT	3	1
TTACCAGCTTCTTTT	TTACCAGCTTCTTTT	1	1
ATAACATTGCGACTT	ATAACATTGCGACTT	1	1
GTGTGGTTGATGCAT	GTGTGGTTGATGCAT	1	1
TGAAGGATGTCGGGT	TGAAGGATGTCGGGT	2	1
TATAAAACTTGTTAT	TATAAAACTTGTTAT	4	1
ATAGTTTGGATTTAA	ATAGTTTGGATTTAA	1	1
CGCCAAGGGCGAGTA	CGCCAAGGGCGAGTA	1	1
GACTGGTACTTTAAG	GACTGGTACTTTAAG	1	1
TGTACCGTCTAGATT	TGTACCGTCTAGATT	1	1
GTCGCTCAACGCCTG	GTCGCTCAACGCCTG	3	1
CCTTATTAAAATGAA	CCTTATTAAAATGAA	1	1
TACCGAAACATTCGT	TACCGAAACATTCGT	4	1
TTTTAATAATATCTT	TTTTAATAATATCTT	1	1
TTAAAAGGTGCGGAA	TTAAAAGGTGCGGAA	1	1
TATAAACACTACCGG	TATAAACACTACCGG	1	1
ACTTGGCATTAAATG	ACTTGGCATTAAATG	1	1
GTTTATCTCACACCT	GTTTATCTCACACCT	2	1
GTCGGGTGCGATCAA	GTCGGGTGCGATCAA	4	1
GCAGTTTCCTTTTAT	GCAGTTTCCTTTTAT	1	1
ATGGGAGCGTAGCCT	ATGGGAGCGTAGCCT	1	1
GGGTTCTTGAGTTCA	GGGTTCTTGAGTTCA	3	1
CGGGCATGTACTCGT	CGGGCATGTACTCGT	1	1
CAGAAACTAGATACT	CAGAAACTAGATACT	2	1
TATATTTCGCTATGA	TATATTTCGCTATGA	1	1
GAATCGACATGATAT	GAATCGACATGATAT	3	1
GACGGGGGGTAGTAA	GACGGGGGGTAGTAA	1	1
AGATTTAGTGTTGCA	AGATTTAGTGTTGCA	1	1
TTAAACCACTCGAGT	TTAAACCACTCGAGT	1	1
TATGCGGACGCGACA	TATGCGGACGCGACA	3	1
TGGGGCTAGTGGATG	TGGGGCTAGTGGATG	1	1
CCCTTCTATAACATG	CCCTTCTATAACATG	1	1
GGCTCTAATTGTTAC	GGCTCTAATTGTTAC	1	1
AAACATCTCAGAAGG	AAACATCTCAGAAGG	1	1
GCGTCGCCCAGGTGT	GCGTCGCCCAGGTGT	3	1
TGATGACTATAGACT	TGATGACTATAGACT	1	1
TCTCGGCATTAATTA	TCTCGGCATTAATTA	4	1
GGAATCTTGGCACGT	GGAATCTTGGCACGT	1	1
TCCTAAGTGACTTCA	TCCTAAGTGACTTCA	4	1
CACTTGTGCTAAATA	CACTTGTGCTAAATA	1	1
CGGGATATCTCATTT	CGGGATATCTCATTT	1	1
GCGGGGGTCACCAAT	GCGGGGGTCACCAAT	1	1
GTGCATTCTAGCTTA	GTGCATTCTAGCTTA	2	1
ATTAAGCATATGGAA	ATTAAGCATATGGAA	1	1
TTCGGTGGGGAGATG	TTCGGTGGGGAGATG	2	1
GATAGAGCTTTTCGC	GATAGAGCTTTTCGC	1	1
ATCTTTTTTTCGCTG	ATCTTTTTTTCGCTG	1	1
CGCGGACTTAAACCG	CGCGGACTTAAACCG	1	1
AGAAGTTTGTAGGGG	AGAAGTTTGTAGGGG	6	1
ACTGTTTTGGATCAT	ACTGTTTTGGATCAT	1	1
AAACGGATTTTGTTG	AAACGGATTTTGTTG	1	1
GGTGTACGGGTCCGT	GGTGTACGGGTCCGT	1	1
ATACAGAACAGTCGC	ATACAGAACAGTCGC	2	1
TGCAGTGCTTGTTTT	TGCAGTGCTTGTTTT	2	1
GGGAGTGGGCTGTCG	GGGAGTGGGCTGTCG	1	1
GCGGTACTTATGGGA	GCGGTACTTATGGGA	1	1
TTATTAGTATAAGTA	TTATTAGTATAAGTA	1	1
TCGTTCTGCCTTGTT	TCGTTCTGCCTTGTT	3	1
TAGTTGGGTATCAAC	TAGTTGGGTATCAAC	2	1
ACTATATTGATATAT	ACTATATTGATATAT	1	1
TAGCCGCCTTTCACG	TAGCCGCCTTTCACG	1	1
GGGCGTAGTTGCTCG	GGGCGTAGTTGCTCG	1	1
TAACTTTTATATATC	TAACTTTTATATATC	2	1
CTCATTGTCAGATTG	CTCATTGTCAGATTG	1	1
CAACTTTCCTGTTTT	CAACTTTCCTGTTTT	2	1
ACTCTATCGGCACAT	ACTCTATCGGCACAT	1	1
TCTGTCTCTTAATAA	TCTGTCTCTTAATAA	1	1
ACCTTAGCAGATTAT	ACCTTAGCAGATTAT	2	1
TATGGGAGCCCGGAT	TATGGGAGCCCGGAT	1	1
ATGGGGTCCAAAAAG	ATGGGGTCCAAAAAG	2	1
AAGGATGGTGTACCA	AAGGATGGTGTACCA	1	1
CAATAGCATTAGTGC	CAATAGCATTAGTGC	5	1
GCTCCCTTAATTATC	GCTCCCTTAATTATC	1	1
TAAGATTCAATTCAT	TAAGATTCAATTCAT	1	1
GTGTAAGCCGTTGCT	GTGTAAGCCGTTGCT	2	1
AGGTCGGATACACTA	AGGTCGGATACACTA	2	1
GATGTTGTAATGCTT	GATGTTGTAATGCTT	1	1
ATCACTGATGTGGAG	ATCACTGATGTGGAG	2	1
TTACTATATTTACTT	TTACTATATTTACTT	2	1
CCTGTGGGTTAGGGA	CCTGTGGGTTAGGGA	2	1
ATTTGTAACCTCTAT	ATTTGTAACCTCTAT	2	1
ATCTATGTGTGGGGA	ATCTATGTGTGGGGA	2	1
ACTAACATTCTAGGT	ACTAACATTCTAGGT	1	1
GTCCTCCACGTAGTT	GTCCTCCACGTAGTT	2	1
CAGAGGGGTTAGGCT	CAGAGGGGTTAGGCT	1	1
TAGGAAAGTACTTTG	TAGGAAAGTACTTTG	1	1
AATAGGTAATCGAAT	AATAGGTAATCGAAT	1	1
ATCCAGAGAGGACTT	ATCCAGAGAGGACTT	1	1
GGTCGGATGGCACCT	GGTCGGATGGCACCT	1	1
AACGTCATTTTTGAT	AACGTCATTTTTGAT	1	1
TAACTGTGGTCATCT	TAACTGTGGTCATCT	1	1
CTGGACTCGTGGTAT	CTGGACTCGTGGTAT	2	1
TTATCTCATATCAAC	TTATCTCATATCAAC	1	1
AGTTGTGTTCATGTT	AGTTGTGTTCATGTT	1	1
GAATGTAAAGTTAGA	GAATGTAAAGTTAGA	1	1
TCTTACCTGGTCGAA	TCTTACCTGGTCGAA	2	1
ACTAGTATAAAACTT	ACTAGTATAAAACTT	1	1
CAGGTGGGATGCGGT	CAGGTGGGATGCGGT	2	1
AACGCACCTTCACTT	AACGCACCTTCACTT	4	1
TTATGTGTGGGCTGT	TTATGTGTGGGCTGT	1	1
ATTACTCTTGCGCAT	ATTACTCTTGCGCAT	5	1
GCAAAATTTATCATA	GCAAAATTTATCATA	3	1
ATAGAACGATAGGAG	ATAGAACGATAGGAG	1	1
GAACCGTCACATTTG	GAACCGTCACATTTG	1	1
ATTCAGTCAGTTCTG	ATTCAGTCAGTTCTG	3	1
CAATGTATATTCTAT	CAATGTATATTCTAT	1	1
ATTATTATCTCTAGT	ATTATTATCTCTAGT	2	1
ACGCGTTACTATTAA	ACGCGTTACTATTAA	1	1
ATCGCTGCTCTCCAT	ATCGCTGCTCTCCAT	6	1
GACACATCCGCGTAG	GACACATCCGCGTAG	1	1
TTATAGTGCGAATAA	TTATAGTGCGAATAA	3	1
CAAATCTTATATGAG	CAAATCTTATATGAG	1	1
TTTAGTTCGTCTCAT	TTTAGTTCGTCTCAT	3	1
GCGGCGTTCCTAGAT	GCGGCGTTCCTAGAT	1	1
CCATTATAACGTGAA	CCATTATAACGTGAA	3	1
TGTTGCTCTCTATGC	TGTTGCTCTCTATGC	2	1
AGAAGCTAATATATG	AGAAGCTAATATATG	4	1
GAAGAATTCCTCAAC	GAAGAATTCCTCAAC	2	1
TTTGTCCCCCAGTAA	TTTGTCCCCCAGTAA	6	1
CCGTAACTAACTTTT	CCGTAACTAACTTTT	1	1
ATAGATACACTCGTT	ATAGATACACTCGTT	1	1
GAGGGTGTCGCATAA	GAGGGTGTCGCATAA	1	1
TAGAAGAAGTAGTAT	TAGAAGAAGTAGTAT	2	1
GATTCTATCCTTGTT	GATTCTATCCTTGTT	1	1
TAAAAGGTTATTGTT	TAAAAGGTTATTGTT	2	1
TTAGTATGTTGCGGT	TTAGTATGTTGCGGT	1	1
CATTTCCTTTGTGTT	CATTTCCTTTGTGTT	1	1
CATGCCAATTGTGCA	CATGCCAATTGTGCA	1	1
GGGGTGGGTTGTTAT	GGGGTGGGTTGTTAT	1	1
ACAAGAGTAGAGGGG	ACAAGAGTAGAGGGG	1	1
GGGGGCTAGGGACTT	GGGGGCTAGGGACTT	2	1
ACTCGATATTAGTTT	ACTCGATATTAGTTT	1	1
TCCTCGTGCGCGTAT	TCCTCGTGCGCGTAT	1	1
GCCGGTGTGAATTTG	GCCGGTGTGAATTTG	1	1
CTAGCATCGCTACTG	CTAGCATCGCTACTG	1	1
CTAAAAGGTTTGGTT	CTAAAAGGTTTGGTT	1	1
TAGTGTCATTAGGTA	TAGTGTCATTAGGTA	1	1
AATAATCTACCTCTA	AATAATCTACCTCTA	1	1
GGAATGAGCTACGCG	GGAATGAGCTACGCG	1	1
TTTTAGGGCAGGTTT	TTTTAGGGCAGGTTT	3	1
GTTTGGGTCTTTAGT	GTTTGGGTCTTTAGT	3	1
CTTTGGGTGTGGGGC	CTTTGGGTGTGGGGC	1	1
TGTCGGTCCTTTTTT	TGTCGGTCCTTTTTT	1	1
GGAGGGTGGCTCGGG	GGAGGGTGGCTCGGG	6	1
TATTATCATTCTGTT	TATTATCATTCTGTT	1	1
GTACCCATAAGTCTC	GTACCCATAAGTCTC	1	1
AATACTGGTCTTGCC	AATACTGGTCTTGCC	1	1
GCTTAGGCATAGTAA	GCTTAGGCATAGTAA	1	1
CTTAGAGTCCCTACA	CTTAGAGTCCCTACA	1	1
GCATACTCGTATTAT	GCATACTCGTATTAT	1	1
TTACTTTACGGTTCA	TTACTTTACGGTTCA	2	1
CGTTGCTGATCGTTC	CGTTGCTGATCGTTC	2	1
GTATCGCTTATGAAT	GTATCGCTTATGAAT	2	1
GTATGGTTTGGGACA	GTATGGTTTGGGACA	1	1
ATCGGATGAGTGAGT	ATCGGATGAGTGAGT	2	1
CCCCGTATATCAAAT	CCCCGTATATCAAAT	1	1
GACTGGGCGGGGCTG	GACTGGGCGGGGCTG	1	1
TTCGCGGGTGGGTAG	TTCGCGGGTGGGTAG	1	1
TTGTGTGGGCGCGGG	TTGTGTGGGCGCGGG	1	1
TGTCGGAATATGTGA	TGTCGGAATATGTGA	1	1
TCAGAGCAATTTCAG	TCAGAGCAATTTCAG	1	1
TTATCTTGTTGATTA	TTATCTTGTTGATTA	1	1
GATCTGTTTTGAAGG	GATCTGTTTTGAAGG	2	1
GGATGTCGGTCCGGG	GGATGTCGGTCCGGG	1	1
AAAATACTGGACCTT	AAAATACTGGACCTT	1	1
TTTTTAAAATTAATA	TTTTTAAAATTAATA	5	1
ACCAACGATAACTCA	ACCAACGATAACTCA	2	1
TTCCGTAGTAATATA	TTCCGTAGTAATATA	1	1
AGTATTATACATAGT	AGTATTATACATAGT	2	1
GAAGACATCGCGTAT	GAAGACATCGCGTAT	5	1
GCCATTGCATATCGT	GCCATTGCATATCGT	2	1
TTTGGGCTGTTCAGT	TTTGGGCTGTTCAGT	1	1
ATAGACACTGCATAA	ATAGACACTGCATAA	1	1
AACAAGCTTAGTGTC	AACAAGCTTAGTGTC	5	1
AGTTGGACGCTTGGG	AGTTGGACGCTTGGG	1	1
TACATTTACTTACCA	TACATTTACTTACCA	1	1
AAGACGGGGCTTAAT	AAGACGGGGCTTAAT	1	1
GTTCTTCATGTCTTA	GTTCTTCATGTCTTA	3	1
ATTCCTTGATTTGGG	ATTCCTTGATTTGGG	1	1
TGAACGGGTTAGAAA	TGAACGGGTTAGAAA	1	1
CCACTGACGACTCAT	CCACTGACGACTCAT	1	1
TAATATTCCATGGTA	TAATATTCCATGGTA	1	1
CATACATGTTAAAAA	CATACATGTTAAAAA	1	1
TAAACATATCTTCGC	TAAACATATCTTCGC	1	1
TATTGCACAGAATCT	TATTGCACAGAATCT	1	1
TGTCCGAAAGGGGCG	TGTCCGAAAGGGGCG	1	1
GGAATAAGAATACCT	GGAATAAGAATACCT	2	1
TTTGTATAATCACAT	TTTGTATAATCACAT	1	1
GTTTTGTAGAGTTCT	GTTTTGTAGAGTTCT	2	1
TTATAAATTTAAAAA	TTATAAATTTAAAAA	1	1
TTACTAGCGGTTCTA	TTACTAGCGGTTCTA	1	1
ATTCTTGAATTAGAG	ATTCTTGAATTAGAG	1	1
ACTGGTAACTATCGT	ACTGGTAACTATCGT	2	1
GCGCCGGGGGCGCGG	GCGCCGGGGGCGCGG	3	1
TTAGAACGTGAGAGC	TTAGAACGTGAGAGC	2	1
ATGGACTCTCTTTAA	ATGGACTCTCTTTAA	5	1
CTTTCGTGTGGCTCT	CTTTCGTGTGGCTCT	1	1
GTTAAGCTTTATGGG	GTTAAGCTTTATGGG	1	1
AAGTGATTTCTGTAA	AAGTGATTTCTGTAA	3	1
GTCTTAAGCACGAGT	GTCTTAAGCACGAGT	1	1
CTCTTGTAGGTTACG	CTCTTGTAGGTTACG	1	1
ATCTTTAGTCTAGAT	ATCTTTAGTCTAGAT	1	1
TGAGCTTAGTCATTC	TGAGCTTAGTCATTC	2	1
TCAATGGGCGATTAA	TCAATGGGCGATTAA	2	1
ATAGTATCGCCAGCA	ATAGTATCGCCAGCA	1	1
CAATTAGACTTCCCA	CAATTAGACTTCCCA	1	1
GTAGGTACAGTGGGT	GTAGGTACAGTGGGT	1	1
GCCATTCACTAGCTG	GCCATTCACTAGCTG	1	1
GAATTGGTTGTTTAT	GAATTGGTTGTTTAT	1	1
TCCGAACAACATCTA	TCCGAACAACATCTA	2	1
CTGATACTTACAGGA	CTGATACTTACAGGA	1	1
TCACATTCTTTGTTC	TCACATTCTTTGTTC	1	1
CGCGTGAGGCCGTCC	CGCGTGAGGCCGTCC	3	1
GCGTGGGCACGTGCA	GCGTGGGCACGTGCA	4	1
ATTGCTAACACATAT	ATTGCTAACACATAT	2	1
GTCAGAGATTTTTAA	GTCAGAGATTTTTAA	1	1
ACTAAGAACTAATTG	ACTAAGAACTAATTG	1	1
TAAAGATACAAGCTT	TAAAGATACAAGCTT	3	1
TTAGGGAGACGGGGT	TTAGGGAGACGGGGT	2	1
ATTTTAATGGTAATT	ATTTTAATGGTAATT	1	1
GTCATACATTCTCTT	GTCATACATTCTCTT	1	1
AATAACGATAAAATA	AATAACGATAAAATA	2	1
AATGGTCCTCTAGTT	AATGGTCCTCTAGTT	1	1
ATTAACTATCGCCTA	ATTAACTATCGCCTA	1	1
CGGTGGATTAAGGAG	CGGTGGATTAAGGAG	1	1
ACATCTTTAATTGTG	ACATCTTTAATTGTG	1	1
GTAGATTTTTTTATA	GTAGATTTTTTTATA	1	1
GACGGCACTGTTTGG	GACGGCACTGTTTGG	1	1
GGCTACACATGTATT	GGCTACACATGTATT	2	1
TATCAAGGAAATTTC	TATCAAGGAAATTTC	1	1
AGCTCTGCATTGTAT	AGCTCTGCATTGTAT	1	1
CATGTGCAAACATCC	CATGTGCAAACATCC	1	1
CACGTGCGTGAGTAA	CACGTGCGTGAGTAA	1	1
ACGAACGATAGTCGT	ACGAACGATAGTCGT	1	1
GTCATTTCTAATACT	GTCATTTCTAATACT	1	1
GTCTAGTGACAATCT	GTCTAGTGACAATCT	1	1
CGGGCCAGAAACTTG	CGGGCCAGAAACTTG	1	1
AAATATTTTCATTGT	AAATATTTTCATTGT	1	1
TTTTCTAATATGTTA	TTTTCTAATATGTTA	1	1
ACTAGTAGCGTTTAT	ACTAGTAGCGTTTAT	1	1
CGCTTATCGGATGGT	CGCTTATCGGATGGT	1	1
TACGAAGGTCCTTTG	TACGAAGGTCCTTTG	1	1
TCTCATGTTGCGCAC	TCTCATGTTGCGCAC	4	1
AAAGGGTATCGGGTG	AAAGGGTATCGGGTG	1	1
GGGTAGTGCCTATGT	GGGTAGTGCCTATGT	1	1
TTCACGATTGGTAAG	TTCACGATTGGTAAG	1	1
TCATCTCTCAGCTTT	TCATCTCTCAGCTTT	1	1
TTCTATCACGGCTTC	TTCTATCACGGCTTC	1	1
AAGTCGCAAATAGTC	AAGTCGCAAATAGTC	2	1
TTTATTTCGGAAAGA	TTTATTTCGGAAAGA	1	1
TCAGGGGATGGTTGT	TCAGGGGATGGTTGT	2	1
GACGCCCTGCTTGGA	GACGCCCTGCTTGGA	1	1
CAGTTGTTCAAAGGT	CAGTTGTTCAAAGGT	3	1
GGTCGCTGTAACGAC	GGTCGCTGTAACGAC	1	1
TAACTCTCTGCGGTA	TAACTCTCTGCGGTA	1	1
AGTATATTTAACAAA	AGTATATTTAACAAA	1	1
TGATCTCACTTAGCT	TGATCTCACTTAGCT	1	1
CGTTTGTTAGGTCAC	CGTTTGTTAGGTCAC	3	1
CCTGGTCTTCACTCA	CCTGGTCTTCACTCA	5	1
AAACACCCTAAATGA	AAACACCCTAAATGA	1	1
ACTGTGTAAACTGGA	ACTGTGTAAACTGGA	2	1
CATGCCAGTTCAATC	CATGCCAGTTCAATC	1	1
AGTTGAATGACAATT	AGTTGAATGACAATT	1	1
GGGAGAGGTTTTAAT	GGGAGAGGTTTTAAT	2	1
TAATAACAGTTCGAA	TAATAACAGTTCGAA	1	1
TGTTCCTTTAACCAG	TGTTCCTTTAACCAG	1	1
GCATGATCCCAATTG	GCATGATCCCAATTG	1	1
AACGTTGTATAGAAG	AACGTTGTATAGAAG	1	1
GCATGGCGCTAGAGG	GCATGGCGCTAGAGG	4	1
CTTTTGTTTGGTTAG	CTTTTGTTTGGTTAG	2	1
TCGATACATTAGTTG	TCGATACATTAGTTG	2	1
TAGTGTGGCTAGTGT	TAGTGTGGCTAGTGT	1	1
GCTCGAATTAACTTA	GCTCGAATTAACTTA	4	1
ATTCCGTCTAATCAA	ATTCCGTCTAATCAA	6	1
AGGATTTGTGGTATG	AGGATTTGTGGTATG	1	1
TCTGCTCTTTTGCCT	TCTGCTCTTTTGCCT	2	1
TTAGTGTATTCACGA	TTAGTGTATTCACGA	4	1
CGGTGGTGCTGGGTG	CGGTGGTGCTGGGTG	1	1
ACTATTAATCCTTCT	ACTATTAATCCTTCT	5	1
GAATATAGAAAATTT	GAATATAGAAAATTT	2	1
TTAGTATAGACATTT	TTAGTATAGACATTT	2	1
ACGAAGTTCTCCAGA	ACGAAGTTCTCCAGA	10	1
TCTGGGCGTAATGTA	TCTGGGCGTAATGTA	1	1
ACGTTCGGTATTAGA	ACGTTCGGTATTAGA	1	1
GCTCTGTATTCAACA	GCTCTGTATTCAACA	2	1
GTTTACTCGACAATA	GTTTACTCGACAATA	1	1
CGAGTTAGAACTGTC	CGAGTTAGAACTGTC	1	1
CAAACCTAGACGCTA	CAAACCTAGACGCTA	1	1
TGATCTCTCTACGAC	TGATCTCTCTACGAC	1	1
GAAAGACGAACTTTC	GAAAGACGAACTTTC	1	1
TTCTGTTGATCCAAA	TTCTGTTGATCCAAA	2	1
CAGGTATGGGTAACA	CAGGTATGGGTAACA	1	1
TTCCATTATGATGAG	TTCCATTATGATGAG	2	1
TTAGGTCACTCGCTT	TTAGGTCACTCGCTT	1	1
TAATAGGAGTACCCA	TAATAGGAGTACCCA	1	1
CAAAAGAAGTTTGAA	CAAAAGAAGTTTGAA	2	1
ACGTGGCGGGGGCTG	ACGTGGCGGGGGCTG	1	1
GTCCTAAAGGGGATA	GTCCTAAAGGGGATA	1	1
AAGGAACTGTTTTTT	AAGGAACTGTTTTTT	2	1
AATGTAGCCTAGTAT	AATGTAGCCTAGTAT	3	1
CTAACTACCACTGCG	CTAACTACCACTGCG	1	1
AGGGCCCGTTTGGGG	AGGGCCCGTTTGGGG	1	1
TACCCCATTCTACAT	TACCCCATTCTACAT	1	1
AACAAGAAGGTGTCG	AACAAGAAGGTGTCG	3	1
TTAATCTGCTTCAAG	TTAATCTGCTTCAAG	1	1
TAAAAATGGTAATAT	TAAAAATGGTAATAT	1	1
GGTTGAAGTTTATTG	GGTTGAAGTTTATTG	1	1
AGGGTACTAACCCTT	AGGGTACTAACCCTT	1	1
TGTAAGTTTTTCTAA	TGTAAGTTTTTCTAA	1	1
ATGACTTACGGACTT	ATGACTTACGGACTT	2	1
GTAAATTTAACTCGA	GTAAATTTAACTCGA	2	1
TCGCATGGGGTGTTT	TCGCATGGGGTGTTT	1	1
TAAGCTCTCACCTTT	TAAGCTCTCACCTTT	1	1
TACAGTTTTCTCTTT	TACAGTTTTCTCTTT	1	1
TTACGTAAATGGTAA	TTACGTAAATGGTAA	1	1
TGGTCTTAGTACTAG	TGGTCTTAGTACTAG	1	1
TCGTCTGTAATATCA	TCGTCTGTAATATCA	2	1
GACGTGTAACATACT	GACGTGTAACATACT	2	1
AATTGTGTGTACAGT	AATTGTGTGTACAGT	2	1
GTGGGGGAGAATGGG	GTGGGGGAGAATGGG	2	1
TGGAATTTAAGTAGT	TGGAATTTAAGTAGT	2	1
TCATAAATGACTGTT	TCATAAATGACTGTT	1	1
ATATCATCTATTGCT	ATATCATCTATTGCT	2	1
CACGGGCGGGGAATA	CACGGGCGGGGAATA	1	1
GCTTTGTGGGGGAAG	GCTTTGTGGGGGAAG	1	1
TATCAGAGCTAATAT	TATCAGAGCTAATAT	1	1
GTCCAAGTGCTCTGC	GTCCAAGTGCTCTGC	1	1
GATGGTCTAGGTGGG	GATGGTCTAGGTGGG	1	1
GATAGGCATTGCCTA	GATAGGCATTGCCTA	1	1
TACTCCGAGTTAAAT	TACTCCGAGTTAAAT	1	1
TAAAATACGGACGCT	TAAAATACGGACGCT	1	1
CTTTGTGGTGACTTT	CTTTGTGGTGACTTT	1	1
GCGCAAGTTCTTTAC	GCGCAAGTTCTTTAC	2	1
TAGCTAGTTTCCCTG	TAGCTAGTTTCCCTG	1	1
TTTCTCTGGCAACTT	TTTCTCTGGCAACTT	1	1
CTTTCTGATAAAATC	CTTTCTGATAAAATC	1	1
TGCTAAAATTTGATA	TGCTAAAATTTGATA	1	1
TTCTTAAGGGGTGTG	TTCTTAAGGGGTGTG	2	1
ATTATGGTTCTATGC	ATTATGGTTCTATGC	2	1
GTCTGCGTCGGTCCA	GTCTGCGTCGGTCCA	2	1
TTATGAAGTAGAACT	TTATGAAGTAGAACT	1	1
TTCGAGCCGGAGAGG	TTCGAGCCGGAGAGG	1	1
TGCGGGAAAAATACC	TGCGGGAAAAATACC	1	1
TTGCATATTCATGTA	TTGCATATTCATGTA	1	1
CAAAGGATGCGCTTT	CAAAGGATGCGCTTT	1	1
ATTATCGTAGCTTCT	ATTATCGTAGCTTCT	1	1
TATGAGGCTGAGAAA	TATGAGGCTGAGAAA	4	1
GGGAATTTGTCCCTG	GGGAATTTGTCCCTG	1	1
TATCCTATTTATCCT	TATCCTATTTATCCT	2	1
CTCTTCTGGTTTCAT	CTCTTCTGGTTTCAT	1	1
GGTTACTGGTTAAGT	GGTTACTGGTTAAGT	1	1
TACGACAAGATGGTC	TACGACAAGATGGTC	1	1
CGAGTTGTGGGGGGG	CGAGTTGTGGGGGGG	3	1
GACTTTGGATATATT	GACTTTGGATATATT	1	1
GGCGGATGGGGAGAG	GGCGGATGGGGAGAG	1	1
AGGGTACATGTTCTA	AGGGTACATGTTCTA	2	1
TAGATGCGTGTGTGG	TAGATGCGTGTGTGG	1	1
TCATTCCATACTCTC	TCATTCCATACTCTC	2	1
TCTTTATTGTCACGT	TCTTTATTGTCACGT	1	1
GCGCTATCCGTGGAT	GCGCTATCCGTGGAT	1	1
GTTAAGGTTGCACTC	GTTAAGGTTGCACTC	1	1
TCACTTGACTCTCGA	TCACTTGACTCTCGA	1	1
GGAGGCCAAATGCTA	GGAGGCCAAATGCTA	1	1
ATAGAAATTTCGTTT	ATAGAAATTTCGTTT	1	1
ACTGACCCGTCTACT	ACTGACCCGTCTACT	1	1
ATATCTAAATTTAGT	ATATCTAAATTTAGT	2	1
CATGCATATTGTCTT	CATGCATATTGTCTT	1	1
GTTAGCGCTTACGCC	GTTAGCGCTTACGCC	1	1
GATACCATTTTCGAA	GATACCATTTTCGAA	1	1
TTCAGTCGGGCGCCG	TTCAGTCGGGCGCCG	4	1
TACCTGGATAATTAT	TACCTGGATAATTAT	1	1
GTTGTAGAATTCAAA	GTTGTAGAATTCAAA	2	1
ACATTGGCGTGCCGG	ACATTGGCGTGCCGG	4	1
GAAAGCACAGCGATT	GAAAGCACAGCGATT	2	1
ATTCTGCCGGTTTAA	ATTCTGCCGGTTTAA	3	1
TAGAAGTTGTAAGCA	TAGAAGTTGTAAGCA	1	1
TATCCGGGCGACCGT	TATCCGGGCGACCGT	3	1
TTGTAGATGCTTAAC	TTGTAGATGCTTAAC	1	1
GTATCCATTTGGCCA	GTATCCATTTGGCCA	1	1
TGTAATTGGTGCTGT	TGTAATTGGTGCTGT	2	1
AATGTGGTACTTTCT	AATGTGGTACTTTCT	1	1
GTACAGTAGTTTTGA	GTACAGTAGTTTTGA	2	1
TATCCCTTTTTAGTA	TATCCCTTTTTAGTA	1	1
CTGGTCGTGGTGGAG	CTGGTCGTGGTGGAG	1	1
ACAATTAAATTAGGA	ACAATTAAATTAGGA	4	1
ATTCGGTTACATGTG	ATTCGGTTACATGTG	4	1
TGAGTGTCTAAAAAT	TGAGTGTCTAAAAAT	1	1
CAACCAGACGTTAAT	CAACCAGACGTTAAT	1	1
CCATCAAACAACACT	CCATCAAACAACACT	1	1
ATTTCCCTTCAGATA	ATTTCCCTTCAGATA	3	1
GTACGGCGAATTGTA	GTACGGCGAATTGTA	1	1
AGTTGTTTCATCTTT	AGTTGTTTCATCTTT	1	1
GAAATAAGGGTTCAT	GAAATAAGGGTTCAT	1	1
CTCAACGTGCGGAGA	CTCAACGTGCGGAGA	1	1
TTGTAATAAGAGCAA	TTGTAATAAGAGCAA	2	1
CTAGACGATTTTATC	CTAGACGATTTTATC	1	1
GTGATACAGGGCTGG	GTGATACAGGGCTGG	1	1
TTCTCGTATTGAATG	TTCTCGTATTGAATG	1	1
GGCATCGATTACTTT	GGCATCGATTACTTT	2	1
TCCTTACGACATGCA	TCCTTACGACATGCA	3	1
CTTCAGACCCTACTA	CTTCAGACCCTACTA	4	1
TTCATAACCTATTGT	TTCATAACCTATTGT	1	1
ACAAGTGCTCGAGGA	ACAAGTGCTCGAGGA	3	1
CTGCGGTTTCTATAA	CTGCGGTTTCTATAA	1	1
CTCACCTAAGTCCTC	CTCACCTAAGTCCTC	1	1
TTACAAAGATCATTA	TTACAAAGATCATTA	2	1
TTTGAATGGCTTGTA	TTTGAATGGCTTGTA	1	1
TCATTCGTTCTAAGC	TCATTCGTTCTAAGC	1	1
ACAAGCCGCGATCGT	ACAAGCCGCGATCGT	1	1
GCATTCCTCTTTCTC	GCATTCCTCTTTCTC	1	1
TAAAAACCAGCAGCT	TAAAAACCAGCAGCT	3	1
AATATTTACTGCTTA	AATATTTACTGCTTA	3	1
TCTTTGTAATGTGTG	TCTTTGTAATGTGTG	5	1
ATATCTCCTACATCT	ATATCTCCTACATCT	1	1
TCTGTACGTTATTTT	TCTGTACGTTATTTT	1	1
CCGCGGGATTCGGGG	CCGCGGGATTCGGGG	1	1
GATGGCGCAACAATA	GATGGCGCAACAATA	1	1
GGCCTCTATTTTGGG	GGCCTCTATTTTGGG	1	1
TAATGCGTTTTGCCA	TAATGCGTTTTGCCA	1	1
CTCAATCGATTGTAT	CTCAATCGATTGTAT	2	1
ACCTTACGACACAAA	ACCTTACGACACAAA	2	1
GTAGACTGCTATGTA	GTAGACTGCTATGTA	1	1
TGCCTGGGGTTCCAA	TGCCTGGGGTTCCAA	1	1
TCCTTTGAAAAAAGC	TCCTTTGAAAAAAGC	1	1
GACGAAGAAAGCGAA	GACGAAGAAAGCGAA	2	1
AGATTGGCAAATAAT	AGATTGGCAAATAAT	1	1
ATCCTGTTGTTGGGG	ATCCTGTTGTTGGGG	1	1
AATATGGATTCACTG	AATATGGATTCACTG	3	1
CTGTTTGTACTTGTT	CTGTTTGTACTTGTT	1	1
TCCTTATAATGCTCT	TCCTTATAATGCTCT	1	1
GACTCTATACCATCT	GACTCTATACCATCT	1	1
AAAGGGAATTTGATA	AAAGGGAATTTGATA	1	1
ATTTGCTCACAATTA	ATTTGCTCACAATTA	1	1
TTCGTCTGGTACTTT	TTCGTCTGGTACTTT	1	1
CCACAATACAGGAAT	CCACAATACAGGAAT	1	1
TGGACTTAACTGTGT	TGGACTTAACTGTGT	1	1
AAAAATGCGGTCAGG	AAAAATGCGGTCAGG	1	1
ACCCACTTTAATTCA	ACCCACTTTAATTCA	1	1
ATTCGTAGAATGCTA	ATTCGTAGAATGCTA	1	1
GCTCATGTCGATATT	GCTCATGTCGATATT	1	1
TTATTTTTAGTAGTG	TTATTTTTAGTAGTG	1	1
TCAGTATATTGTCGG	TCAGTATATTGTCGG	1	1
AGTACGAAGCGTGGT	AGTACGAAGCGTGGT	1	1
GGCAAAATCTATTGT	GGCAAAATCTATTGT	2	1
TGCTTTCCGTGTATA	TGCTTTCCGTGTATA	1	1
CTCTACTTATTGCGT	CTCTACTTATTGCGT	4	1
CGACCGACAACAGTC	CGACCGACAACAGTC	1	1
AACTTTATAGTAGAA	AACTTTATAGTAGAA	1	1
TTAAGTGAACTCGCT	TTAAGTGAACTCGCT	1	1
GAGGACATTAATGTA	GAGGACATTAATGTA	1	1
CTTGTTGACTAAACT	CTTGTTGACTAAACT	1	1
TAAACTTTCTTACCG	TAAACTTTCTTACCG	1	1
AATTTGAAAACGGAA	AATTTGAAAACGGAA	1	1
CTAGGCTGAAGGCAT	CTAGGCTGAAGGCAT	1	1
CTTTAGCGTATTGGT	CTTTAGCGTATTGGT	1	1
CTTATCTTTTATAAT	CTTATCTTTTATAAT	2	1
TTAAGTTAGGAATTT	TTAAGTTAGGAATTT	2	1
GGTTTAGGAGACTTC	GGTTTAGGAGACTTC	2	1
ATCTGACTTGGGCTT	ATCTGACTTGGGCTT	1	1
GTTGGCAGGTGGTGA	GTTGGCAGGTGGTGA	1	1
GCAATGTTTTGGTTC	GCAATGTTTTGGTTC	1	1
TCCTGCAGATGCTTT	TCCTGCAGATGCTTT	1	1
ATATTTGAGATGGGT	ATATTTGAGATGGGT	1	1
TTAAAAGTAAAACCT	TTAAAAGTAAAACCT	3	1
TGTCACCTTTTACTG	TGTCACCTTTTACTG	2	1
CTTATAGTAACCAAT	CTTATAGTAACCAAT	1	1
TGCTGAACGTGATAT	TGCTGAACGTGATAT	1	1
CATAACTAAAACGGT	CATAACTAAAACGGT	1	1
GGAGATAAGTGCGGC	GGAGATAAGTGCGGC	1	1
TGTTCTTGCGGGTAG	TGTTCTTGCGGGTAG	1	1
TCGCAATGAGTATTT	TCGCAATGAGTATTT	1	1
GGAATGCTGATATAA	GGAATGCTGATATAA	1	1
GTAATGTCCTGTGGT	GTAATGTCCTGTGGT	1	1
TTGTATCATAAATTT	TTGTATCATAAATTT	2	1
AACTTAGTCTTACAC	AACTTAGTCTTACAC	1	1
TTCTAAACTTTGCGT	TTCTAAACTTTGCGT	2	1
TGTGATTAACAGGCG	TGTGATTAACAGGCG	1	1
ACTTACACGTCCTCT	ACTTACACGTCCTCT	1	1
TTAAAATTCTTGAAG	TTAAAATTCTTGAAG	3	1
TTTACACAGTCGTTT	TTTACACAGTCGTTT	1	1
TGAAAAGACTAATTT	TGAAAAGACTAATTT	2	1
CCGTACTAGACGTCC	CCGTACTAGACGTCC	2	1
TAGTATCATATGAAC	TAGTATCATATGAAC	3	1
TCCTGTGCTATTAAA	TCCTGTGCTATTAAA	1	1
TTTCGTCAGTGATAT	TTTCGTCAGTGATAT	1	1
ATAGTCATCCGCATT	ATAGTCATCCGCATT	1	1
TATGGCCCTCTAATA	TATGGCCCTCTAATA	1	1
CTATTATGGGCCTAA	CTATTATGGGCCTAA	1	1
TGCGTTAATGTTCTA	TGCGTTAATGTTCTA	1	1
TTACCATACGGTAAA	TTACCATACGGTAAA	4	1
TTACTTTGTAGAAAA	TTACTTTGTAGAAAA	1	1
TCTTATTAATATTTC	TCTTATTAATATTTC	3	1
GAAAGATTTCTATCG	GAAAGATTTCTATCG	1	1
CTCACATAATTTATG	CTCACATAATTTATG	1	1
GGCTGATGGGAGCGC	GGCTGATGGGAGCGC	1	1
GTATAGACTTTACAA	GTATAGACTTTACAA	2	1
TGGATAATATCACGG	TGGATAATATCACGG	1	1
CTATCCACAAAATCT	CTATCCACAAAATCT	2	1
GTTTCATCATTAGGA	GTTTCATCATTAGGA	2	1
GGATGTATTATCCCC	GGATGTATTATCCCC	1	1
TTCGGCGCAACACTT	TTCGGCGCAACACTT	1	1
AACATACTGTGCTAA	AACATACTGTGCTAA	1	1
TCATACAAAGTCATG	TCATACAAAGTCATG	1	1
CTATCATCTGCTTCT	CTATCATCTGCTTCT	1	1
AATTTCACAGGTGCC	AATTTCACAGGTGCC	2	1
TGGGTACGGATAAGG	TGGGTACGGATAAGG	1	1
AAAAAATGATTTGCT	AAAAAATGATTTGCT	1	1
AGTCATTACTGTTTT	AGTCATTACTGTTTT	1	1
TTTCCGAACACTGTT	TTTCCGAACACTGTT	1	1
CGATCGCATTTACCT	CGATCGCATTTACCT	1	1
CCTACGATTATGTGT	CCTACGATTATGTGT	1	1
TGTTAAAAATGAGGA	TGTTAAAAATGAGGA	1	1
CCATAATTGAAAGTT	CCATAATTGAAAGTT	1	1
TCCTCAGGTAGAGCG	TCCTCAGGTAGAGCG	1	1
AATTGTTTTTAGTCG	AATTGTTTTTAGTCG	1	1
GCAGTCTATTTATTT	GCAGTCTATTTATTT	1	1
GAGCTTAGAAAAACA	GAGCTTAGAAAAACA	1	1
CAGCGACAGCTTATC	CAGCGACAGCTTATC	3	1
AATAGGTTCCAGCGT	AATAGGTTCCAGCGT	1	1
TGGGGGAGTGTTGCC	TGGGGGAGTGTTGCC	1	1
ACCTGCCTTACGATC	ACCTGCCTTACGATC	1	1
GGGTAATTTCACCAT	GGGTAATTTCACCAT	2	1
TGAACTGAACATTCA	TGAACTGAACATTCA	2	1
GGAGCGCGCTCGGAG	GGAGCGCGCTCGGAG	1	1
GGTGGTCGAGCCGTG	GGTGGTCGAGCCGTG	1	1
ATAGCTCATAGATGA	ATAGCTCATAGATGA	1	1
CGGGGTATAGCAGGG	CGGGGTATAGCAGGG	1	1
TTGTTATACTAATTC	TTGTTATACTAATTC	2	1
GCTGACGCTGCAGCT	GCTGACGCTGCAGCT	2	1
AGAGGATGCCTGATG	AGAGGATGCCTGATG	3	1
ACGTCCAGTGAGTCG	ACGTCCAGTGAGTCG	2	1
AATTCATTCCATCTA	AATTCATTCCATCTA	3	1
GTATTGAACTCTTTC	GTATTGAACTCTTTC	2	1
CCATCAGACCCGTAT	CCATCAGACCCGTAT	2	1
GGTGCCAAATTCCAT	GGTGCCAAATTCCAT	2	1
ATCACTTCTACTTCC	ATCACTTCTACTTCC	1	1
ATACCATAACTCTTT	ATACCATAACTCTTT	1	1
CTATCCAAAATTGTT	CTATCCAAAATTGTT	1	1
GGCCAAATGTTCTCT	GGCCAAATGTTCTCT	1	1
GAATCGATGCTAAAA	GAATCGATGCTAAAA	2	1
GGTAATAATTTTTCT	GGTAATAATTTTTCT	1	1
GAAACCTTGAGCCCA	GAAACCTTGAGCCCA	1	1
ACTATTAACATGAAT	ACTATTAACATGAAT	1	1
CTTCTTAGTTTCGTC	CTTCTTAGTTTCGTC	3	1
TTAGTAGCGGCATAG	TTAGTAGCGGCATAG	3	1
AAATTGTCCAGGAAT	AAATTGTCCAGGAAT	1	1
AGCGAATTGTTTAAC	AGCGAATTGTTTAAC	1	1
AGAACATAGAATCTA	AGAACATAGAATCTA	1	1
CTCGTGTACCAGTAG	CTCGTGTACCAGTAG	1	1
TATACAAATTAAGCC	TATACAAATTAAGCC	1	1
TGGTCGTAGATGGCG	TGGTCGTAGATGGCG	2	1
GGTAAGAACCAAAAT	GGTAAGAACCAAAAT	1	1
TACTGAAGTCAAGGA	TACTGAAGTCAAGGA	2	1
CTCCATGTTACTATT	CTCCATGTTACTATT	1	1
CCCAGTGACTTTGTG	CCCAGTGACTTTGTG	1	1
TACCACTTAGTGGCA	TACCACTTAGTGGCA	1	1
AGGGAAACGGTGTGG	AGGGAAACGGTGTGG	1	1
TGCAGACCCTCCGTT	TGCAGACCCTCCGTT	4	1
CTGTCGTGTTGACTT	CTGTCGTGTTGACTT	1	1
TGGATGTAACCACGT	TGGATGTAACCACGT	1	1
CGGATACATTTCTAT	CGGATACATTTCTAT	1	1
TCTCCGACAGGGGCA	TCTCCGACAGGGGCA	1	1
GTCGATACTTAGTTA	GTCGATACTTAGTTA	1	1
GCAGGGCGGAGTGTA	GCAGGGCGGAGTGTA	4	1
TAAACTAACAGCAAT	TAAACTAACAGCAAT	1	1
GATATTCTTATATGT	GATATTCTTATATGT	2	1
AGAGGTGAGTGTTCC	AGAGGTGAGTGTTCC	1	1
TGTTAGGTCAGCCCT	TGTTAGGTCAGCCCT	1	1
ACTAAATAAAGACGC	ACTAAATAAAGACGC	1	1
AGACATCGTGATCCT	AGACATCGTGATCCT	1	1
GTACGCATCCTATGT	GTACGCATCCTATGT	1	1
CTCTTGCAAAGTAGA	CTCTTGCAAAGTAGA	1	1
ATGTCTGGGCTAATA	ATGTCTGGGCTAATA	1	1
CAATAATAACTTTCG	CAATAATAACTTTCG	1	1
GATGTGATGATGCAC	GATGTGATGATGCAC	4	1
TGTTTAATGAAGTTG	TGTTTAATGAAGTTG	2	1
GTGAGGATGGCGTGG	GTGAGGATGGCGTGG	1	1
CAATCTACCTAGAAG	CAATCTACCTAGAAG	1	1
GGTCGTAACTTTTTG	GGTCGTAACTTTTTG	1	1
TCAACTATGACAAAT	TCAACTATGACAAAT	1	1
AGCGCAGATATAATA	AGCGCAGATATAATA	1	1
TCCCGTTTTGAGTAC	TCCCGTTTTGAGTAC	1	1
TAGGACAGTGTTATG	TAGGACAGTGTTATG	1	1
GGCCACCGTCTGTTC	GGCCACCGTCTGTTC	2	1
TGGTAAATCGAGATT	TGGTAAATCGAGATT	2	1
GGGGACTGCTCTAAA	GGGGACTGCTCTAAA	1	1
CAATCTAAAAACTTT	CAATCTAAAAACTTT	1	1
GTCGGGGGGATATTT	GTCGGGGGGATATTT	5	1
CCAGGGTGGTGGGCG	CCAGGGTGGTGGGCG	1	1
TGAACGTGCTCAATG	TGAACGTGCTCAATG	1	1
TTGGTTATTAAGCGT	TTGGTTATTAAGCGT	1	1
GATGTCTCTGTTATG	GATGTCTCTGTTATG	2	1
TGGAGTTTGCATGAA	TGGAGTTTGCATGAA	3	1
AGATTTGGGTAAAGT	AGATTTGGGTAAAGT	1	1
GTTAATCACACTCTT	GTTAATCACACTCTT	1	1
CTCAACCTCCATAAA	CTCAACCTCCATAAA	1	1
TCCATGCCATGCGGA	TCCATGCCATGCGGA	1	1
GGCTGGCGGGCGGTG	GGCTGGCGGGCGGTG	2	1
GACTTCACAGATGGC	GACTTCACAGATGGC	1	1
TGATAAGTATTTCTC	TGATAAGTATTTCTC	1	1
TTCGCTACACATATT	TTCGCTACACATATT	2	1
GGCCGTGAAGCGGGA	GGCCGTGAAGCGGGA	1	1
GGATTCAGTTTCTCA	GGATTCAGTTTCTCA	1	1
ATAATTAATTAACAT	ATAATTAATTAACAT	1	1
TGTAAGCTTCTATTC	TGTAAGCTTCTATTC	1	1
TGCTATCACCGTATC	TGCTATCACCGTATC	2	1
CGTAACTAGCGGTTA	CGTAACTAGCGGTTA	3	1
TCACATACACATAGG	TCACATACACATAGG	1	1
ACTAGTGTAAATTTT	ACTAGTGTAAATTTT	1	1
GTCAAATAGCAAATA	GTCAAATAGCAAATA	1	1
TCGATGCCAGACAAT	TCGATGCCAGACAAT	1	1
GCGAAAGGGTAAAAT	GCGAAAGGGTAAAAT	1	1
AGTGTCAGATTGTTA	AGTGTCAGATTGTTA	2	1
AAGCGGGGCGGTGGC	AAGCGGGGCGGTGGC	1	1
TGTATAGAAACACAT	TGTATAGAAACACAT	1	1
CGCCTCTGTCGTAGA	CGCCTCTGTCGTAGA	2	1
GTTGTACTTTAGAAG	GTTGTACTTTAGAAG	1	1
ACATCTGGTAGCAAG	ACATCTGGTAGCAAG	3	1
TTGGGATCCAGTTTT	TTGGGATCCAGTTTT	3	1
TCCTAATCCAACTAT	TCCTAATCCAACTAT	1	1
ACGAATAATTACGTG	ACGAATAATTACGTG	2	1
GTAACCTATTAGCAA	GTAACCTATTAGCAA	2	1
GAGATTTAAACTTTG	GAGATTTAAACTTTG	2	1
TTAGCCTAGCCCTGT	TTAGCCTAGCCCTGT	1	1
GGGGGGTGGGTGGTG	GGGGGGTGGGTGGTG	1	1
AAGGGTACATACAAC	AAGGGTACATACAAC	1	1
TCGGTGTAAGTCAGT	TCGGTGTAAGTCAGT	3	1
ACTATATAATACATC	ACTATATAATACATC	1	1
CTTGCATTATCACAC	CTTGCATTATCACAC	1	1
ACCGTGGCTTCGTGC	ACCGTGGCTTCGTGC	2	1
ATAATTAACGTTCTA	ATAATTAACGTTCTA	3	1
ACCTTTATAAAGATG	ACCTTTATAAAGATG	1	1
CTAAGGTCCGTATTA	CTAAGGTCCGTATTA	1	1
AATTCTTTCGCTTTA	AATTCTTTCGCTTTA	1	1
CCATTGGCATCTACT	CCATTGGCATCTACT	3	1
GTATACAGTTCATAG	GTATACAGTTCATAG	3	1
GAAAAGCCTCCTATT	GAAAAGCCTCCTATT	2	1
TTTCGGCAACGCGTT	TTTCGGCAACGCGTT	1	1
GAAAGTATCATTACT	GAAAGTATCATTACT	4	1
AAAATATTTTTATAT	AAAATATTTTTATAT	3	1
GCGTATAGGTAAAAT	GCGTATAGGTAAAAT	1	1
CGCTGCCACCAACTT	CGCTGCCACCAACTT	1	1
GTCAATCGTGGTGGA	GTCAATCGTGGTGGA	2	1
CATGCTCATTTGAAT	CATGCTCATTTGAAT	1	1
ATGTCTACTGGTGAC	ATGTCTACTGGTGAC	1	1
CAGTCTTATAACCTC	CAGTCTTATAACCTC	1	1
GGGGGGGGAGGGGGG	GGGGGGGGAGGGGGG	1	1
ATTTGCGCCGTTGGA	ATTTGCGCCGTTGGA	1	1
TAGGGTGCTGGAGTG	TAGGGTGCTGGAGTG	2	1
GTGACCCTCCAAGGT	GTGACCCTCCAAGGT	2	1
GAAGCCGATTTTTGG	GAAGCCGATTTTTGG	1	1
TAAAACAGTCCGGAT	TAAAACAGTCCGGAT	3	1
AAGTTACCTTTGGGG	AAGTTACCTTTGGGG	1	1
CCCTTAAATTCGGCG	CCCTTAAATTCGGCG	2	1
GGAGCTTCTGCTGGT	GGAGCTTCTGCTGGT	1	1
TGAGACGTGATAGTG	TGAGACGTGATAGTG	1	1
GGTTTTGACTCCAGC	GGTTTTGACTCCAGC	1	1
CGTGCCTCCACACCT	CGTGCCTCCACACCT	1	1
CACATTAATTCCAAA	CACATTAATTCCAAA	3	1
TATTGAATTTAACAT	TATTGAATTTAACAT	1	1
GAAATTACGTAATTT	GAAATTACGTAATTT	1	1
GCGCACTTCTTGAGT	GCGCACTTCTTGAGT	1	1
CGCCCTGCTTCTATA	CGCCCTGCTTCTATA	2	1
ATACAGATCGCGTAT	ATACAGATCGCGTAT	1	1
TAAGCTTTGGTATTT	TAAGCTTTGGTATTT	1	1
CGGATTAACATAATA	CGGATTAACATAATA	1	1
GGAATATACTATATC	GGAATATACTATATC	2	1
CAGACTTTAGACACA	CAGACTTTAGACACA	1	1
AAGGCACTGGGACGG	AAGGCACTGGGACGG	1	1
GATATAATCTAAATT	GATATAATCTAAATT	1	1
ATATTCGGTATGTTA	ATATTCGGTATGTTA	1	1
CAGTGTTTGGTGACA	CAGTGTTTGGTGACA	1	1
TTTCTTTCTGGTCTT	TTTCTTTCTGGTCTT	2	1
ATTAGTGTCTCCTAG	ATTAGTGTCTCCTAG	1	1
TGTTTAAGTAATTTG	TGTTTAAGTAATTTG	1	1
CAATTTCTATTCACA	CAATTTCTATTCACA	2	1
TAGCGACAGGAGGTG	TAGCGACAGGAGGTG	2	1
GCTGTGCCTGCAATA	GCTGTGCCTGCAATA	3	1
AATTTTTTAGCAACG	AATTTTTTAGCAACG	1	1
GGGGATTGTTAGTAT	GGGGATTGTTAGTAT	1	1
AACTACGTTACAATA	AACTACGTTACAATA	2	1
TGAAGTACTCGGCTA	TGAAGTACTCGGCTA	1	1
TCGGTCAGACTCACG	TCGGTCAGACTCACG	2	1
TTTTCCTCAATGACT	TTTTCCTCAATGACT	2	1
CGTTGCTAATGTAAG	CGTTGCTAATGTAAG	1	1
TATGTGCGTCTGTGC	TATGTGCGTCTGTGC	1	1
TCACTAATACAAACT	TCACTAATACAAACT	1	1
TTCGACTCATTTCAT	TTCGACTCATTTCAT	1	1
TGCGACGGGGGGCTG	TGCGACGGGGGGCTG	1	1
GCAGCATGTACCTTC	GCAGCATGTACCTTC	1	1
ACTATGACGACTCTC	ACTATGACGACTCTC	3	1
GGGAGTGATGGGAAT	GGGAGTGATGGGAAT	1	1
TTACAGCACCTGTGT	TTACAGCACCTGTGT	1	1
TTACATTTCCCCTAA	TTACATTTCCCCTAA	1	1
GTCATAGCCGTTTGT	GTCATAGCCGTTTGT	1	1
CTCGTGCTCTTCGGG	CTCGTGCTCTTCGGG	1	1
CGAGCAATACATATT	CGAGCAATACATATT	1	1
TTCAGTGCTTGTTTT	TTCAGTGCTTGTTTT	1	1
ATAGGTGCCGAAGTA	ATAGGTGCCGAAGTA	1	1
GTTTGAGTATTGAAT	GTTTGAGTATTGAAT	1	1
AGCATACTTTTGATT	AGCATACTTTTGATT	3	1
GATCTAGTTTTACGT	GATCTAGTTTTACGT	1	1
GTAAAGGTGTGGATT	GTAAAGGTGTGGATT	1	1
TGCCAATGTTGAATC	TGCCAATGTTGAATC	2	1
TGGAAAGGGATGAGT	TGGAAAGGGATGAGT	2	1
GTGCGTCGTTACGGG	GTGCGTCGTTACGGG	1	1
TTACACTCTTCGTTC	TTACACTCTTCGTTC	1	1
CCTGGTTTCGTTTTT	CCTGGTTTCGTTTTT	1	1
CATAGTAGGTCTTAT	CATAGTAGGTCTTAT	1	1
AGCGCAGTAATCTCA	AGCGCAGTAATCTCA	3	1
AATTTGAAACTTTTT	AATTTGAAACTTTTT	1	1
ACGGCTTATCACATT	ACGGCTTATCACATT	2	1
TGGGCATCAACAAGA	TGGGCATCAACAAGA	1	1
TTGGGGCTTACACAT	TTGGGGCTTACACAT	1	1
ACTGTACTCACTCAC	ACTGTACTCACTCAC	1	1
TTAATATCCGTAATT	TTAATATCCGTAATT	2	1
TCTAGGCCTATACTG	TCTAGGCCTATACTG	2	1
GGTCGTTATACTGGG	GGTCGTTATACTGGG	1	1
CATTTATCACGTCGA	CATTTATCACGTCGA	2	1
CTGTCCCATGTAGCG	CTGTCCCATGTAGCG	1	1
TTCGTTCACTTTTGT	TTCGTTCACTTTTGT	1	1
GTTGCTAATAATACA	GTTGCTAATAATACA	1	1
TTCTAGTACCAGTTT	TTCTAGTACCAGTTT	1	1
AGTTCGGCATGGTTA	AGTTCGGCATGGTTA	1	1
CGCTGTTATAGTGGA	CGCTGTTATAGTGGA	2	1
GGATCCTGCCAGACG	GGATCCTGCCAGACG	1	1
AGTACTTCGATCCGT	AGTACTTCGATCCGT	1	1
ATTCAGTTTCCTGTG	ATTCAGTTTCCTGTG	1	1
CTAAGGGTGGAAAAC	CTAAGGGTGGAAAAC	1	1
ATTGCGCGAGGTCGT	ATTGCGCGAGGTCGT	1	1
CCATTAGGTTGCCAT	CCATTAGGTTGCCAT	1	1
TCATACTCCCATTTA	TCATACTCCCATTTA	1	1
TAAATCGATTTTAGT	TAAATCGATTTTAGT	1	1
CCTATATCTCATTTT	CCTATATCTCATTTT	1	1
TATCAAGGGGCGCAT	TATCAAGGGGCGCAT	1	1
TGTCGCGTGAAGTTT	TGTCGCGTGAAGTTT	2	1
GGGGTAACTTCATTC	GGGGTAACTTCATTC	1	1
AAGGTTAATTACGCA	AAGGTTAATTACGCA	1	1
CCTTCCGTGGTTTCA	CCTTCCGTGGTTTCA	1	1
CTACTCATTTAACTC	CTACTCATTTAACTC	1	1
GAAAGTAAACACTGG	GAAAGTAAACACTGG	1	1
GTTCGAGTGTTAAAA	GTTCGAGTGTTAAAA	1	1
ATATTCCACATGAGT	ATATTCCACATGAGT	1	1
GTTGTACAAGAGACT	GTTGTACAAGAGACT	1	1
AATCGTGGGAGCACT	AATCGTGGGAGCACT	1	1
CTTATCTTACTGCTC	CTTATCTTACTGCTC	1	1
TATATATCATACTCG	TATATATCATACTCG	1	1
CGCGTGTCTTATTTA	CGCGTGTCTTATTTA	1	1
AATCGGATTTAATGT	AATCGGATTTAATGT	1	1
ATTGTAGAATGTACA	ATTGTAGAATGTACA	1	1
TGTTGCCTCTTCTAT	TGTTGCCTCTTCTAT	1	1
CTCTTAAGCCCTATA	CTCTTAAGCCCTATA	2	1
ATCGGGACTTCTAAA	ATCGGGACTTCTAAA	2	1
GCAGATGTGCTATAC	GCAGATGTGCTATAC	1	1
TGCGCATCTCCTTTT	TGCGCATCTCCTTTT	1	1
TAGGTGTTCACCGGT	TAGGTGTTCACCGGT	1	1
TCAATTGCGATGGCA	TCAATTGCGATGGCA	1	1
GCCGGACACATTCCG	GCCGGACACATTCCG	2	1
AAAAATAACCTTACT	AAAAATAACCTTACT	1	1
TAGTTTCCTAGTTGA	TAGTTTCCTAGTTGA	1	1
AGCTCTATTTCTTAG	AGCTCTATTTCTTAG	1	1
TTTGAAATTCGTTGC	TTTGAAATTCGTTGC	1	1
TTTCACTGATTTTTC	TTTCACTGATTTTTC	1	1
GATACTGATCGGATA	GATACTGATCGGATA	1	1
GATATCCAAAAGGTT	GATATCCAAAAGGTT	1	1
AAATCGTGTTCATCA	AAATCGTGTTCATCA	2	1
TATCATGTACAAGAA	TATCATGTACAAGAA	1	1
TTGTTTGTTATTAAT	TTGTTTGTTATTAAT	1	1
AAACTAATTTAAATT	AAACTAATTTAAATT	1	1
CGATAGGCCATACAC	CGATAGGCCATACAC	1	1
AATCAATATAAGCTC	AATCAATATAAGCTC	2	1
CTTTATGAGATAGTT	CTTTATGAGATAGTT	1	1
TCTTTAATATTCAAC	TCTTTAATATTCAAC	1	1
ACTACTCTTGATTCA	ACTACTCTTGATTCA	1	1
ATGTAATATTTAACA	ATGTAATATTTAACA	2	1
TTTAAGTTTCTTCAA	TTTAAGTTTCTTCAA	1	1
GGAGAGGGGTCGGAA	GGAGAGGGGTCGGAA	1	1
GGTCTCTTCCGGTAT	GGTCTCTTCCGGTAT	2	1
ATCACAATGTTGTAG	ATCACAATGTTGTAG	2	1
AAATATGAAATTTTA	AAATATGAAATTTTA	1	1
CTATCCGTTCCTGCG	CTATCCGTTCCTGCG	3	1
TGGAGATATATAAAT	TGGAGATATATAAAT	1	1
TATCGATGAGATCCG	TATCGATGAGATCCG	1	1
TAGCCGGGTATGTTA	TAGCCGGGTATGTTA	1	1
AAAACCAAGCTGTTA	AAAACCAAGCTGTTA	1	1
ATATCACGTATGTTT	ATATCACGTATGTTT	2	1
CACCGCAGGTGTCAT	CACCGCAGGTGTCAT	2	1
TTCCATCCAAACTTT	TTCCATCCAAACTTT	1	1
AGGGTGTGGCGATGT	AGGGTGTGGCGATGT	1	1
CAAGGTGAGCACGTG	CAAGGTGAGCACGTG	5	1
GATAGAATTCGATCT	GATAGAATTCGATCT	1	1
TTAGTCGCGGGAATT	TTAGTCGCGGGAATT	2	1
GCAGACTTTGTTACT	GCAGACTTTGTTACT	2	1
TATTGAAGGCAGTCT	TATTGAAGGCAGTCT	1	1
TTTATGATTATTTGT	TTTATGATTATTTGT	2	1
CTTCACACAAGGCGC	CTTCACACAAGGCGC	4	1
TATCCTTTTGAGGTT	TATCCTTTTGAGGTT	1	1
GAATTCTAACTTATA	GAATTCTAACTTATA	1	1
ATTTGTGTGCTCGGT	ATTTGTGTGCTCGGT	1	1
AACATTGCCCAGACT	AACATTGCCCAGACT	1	1
GGATGGGTATATGGG	GGATGGGTATATGGG	3	1
TTGCTCTCACACTTA	TTGCTCTCACACTTA	3	1
CTCGTCGGTTTCGAA	CTCGTCGGTTTCGAA	1	1
AGCTGGATGGTAAAC	AGCTGGATGGTAAAC	1	1
TATTCCTATTGATGT	TATTCCTATTGATGT	1	1
CTTAAAATCATTTGG	CTTAAAATCATTTGG	2	1
CAAACGACCACTTAA	CAAACGACCACTTAA	2	1
GTTATAATTTCAAAT	GTTATAATTTCAAAT	1	1
AATCGCAAATGTAAT	AATCGCAAATGTAAT	1	1
TACACAAAACAATAC	TACACAAAACAATAC	1	1
TAAAAATGTATATCT	TAAAAATGTATATCT	1	1
ATACCATTAAGATAC	ATACCATTAAGATAC	1	1
AAAAAGTACCTTTGG	AAAAAGTACCTTTGG	1	1
CCAGTAGATAAAATT	CCAGTAGATAAAATT	1	1
GGGCAGGCGGAAGTG	GGGCAGGCGGAAGTG	2	1
ATTCATATGTAGCAA	ATTCATATGTAGCAA	2	1
TAGCCTGTCGGCTTA	TAGCCTGTCGGCTTA	2	1
AGTTATAAATCAGGT	AGTTATAAATCAGGT	1	1
CTCCGCTTGTATTAT	CTCCGCTTGTATTAT	1	1
AATTTAACGAGCCTG	AATTTAACGAGCCTG	1	1
GACTGTCGTCTATTT	GACTGTCGTCTATTT	1	1
CTCATTTTCTGGCGT	CTCATTTTCTGGCGT	1	1
GGAAGGTAACTTGCA	GGAAGGTAACTTGCA	1	1
GCTACTTCCTCTTTT	GCTACTTCCTCTTTT	1	1
CGTATGTTCTTTGCT	CGTATGTTCTTTGCT	1	1
TTTTAGTAAAACGGA	TTTTAGTAAAACGGA	1	1
GGTGATTTTGCGATG	GGTGATTTTGCGATG	1	1
TTGACTCTTAATGTA	TTGACTCTTAATGTA	1	1
ACTACCTCAACTCCT	ACTACCTCAACTCCT	1	1
TGCAGTTTCTTGCTC	TGCAGTTTCTTGCTC	1	1
CCAATCAGTCTTAGT	CCAATCAGTCTTAGT	1	1
AGTTACGGTCATTGT	AGTTACGGTCATTGT	1	1
CGCATATATCATTAA	CGCATATATCATTAA	1	1
GCGTCATTCCTTGTC	GCGTCATTCCTTGTC	2	1
GCCTCAGATTAGAGG	GCCTCAGATTAGAGG	2	1
TTAGTCGCGGCAATT	TTAGTCGCGGCAATT	1	1
ATCGGTACTGGGATT	ATCGGTACTGGGATT	2	1
GTAACGAGCGTTCCG	GTAACGAGCGTTCCG	2	1
GCTCTCTCGCTCACT	GCTCTCTCGCTCACT	1	1
TTTTGGCTTACGCCT	TTTTGGCTTACGCCT	1	1
CTAGTTGGCCACATC	CTAGTTGGCCACATC	1	1
GTGCGTGGACAATTA	GTGCGTGGACAATTA	1	1
AGTGCGTCCGCAGTG	AGTGCGTCCGCAGTG	1	1
TCAAGGCTCTCTTGA	TCAAGGCTCTCTTGA	1	1
GAAAGTTTCGATTTT	GAAAGTTTCGATTTT	1	1
ACCTTAGACAGAGGT	ACCTTAGACAGAGGT	1	1
AACTATTCTTTTAGA	AACTATTCTTTTAGA	1	1
CATCTGTAGCGCCAT	CATCTGTAGCGCCAT	1	1
TGAGAGGCCGCTCTA	TGAGAGGCCGCTCTA	1	1
TCTGGGGGGGGGTCC	TCTGGGGGGGGGTCC	1	1
GTCAATATTATTTGG	GTCAATATTATTTGG	3	1
GGAGGTGTGGACGGG	GGAGGTGTGGACGGG	3	1
GAGAATTTTACGATG	GAGAATTTTACGATG	1	1
CTCTTGCCGTCGAAT	CTCTTGCCGTCGAAT	1	1
GTTAAAAACTATACC	GTTAAAAACTATACC	1	1
CCGGTAGAGTCTTTT	CCGGTAGAGTCTTTT	1	1
GCGGATTTGGTCTTC	GCGGATTTGGTCTTC	1	1
AACATCAAAGATTCT	AACATCAAAGATTCT	1	1
CATCGGGTTTAGCGT	CATCGGGTTTAGCGT	1	1
AGATTTTTGGTTAAT	AGATTTTTGGTTAAT	1	1
GTTAACCAGTTTATT	GTTAACCAGTTTATT	1	1
TACATGAATTCTATG	TACATGAATTCTATG	1	1
ATTACAAACCGAATA	ATTACAAACCGAATA	1	1
ACCTATGATCGAATT	ACCTATGATCGAATT	1	1
CATTGATGACGGTGG	CATTGATGACGGTGG	2	1
CTCTATAATCTTATT	CTCTATAATCTTATT	1	1
AAATAAGATGAGTTC	AAATAAGATGAGTTC	3	1
CATATTGTTAGCACT	CATATTGTTAGCACT	1	1
CAATCTTCCAGTTCA	CAATCTTCCAGTTCA	2	1
TTGTTCTGATAGGGG	TTGTTCTGATAGGGG	1	1
CCTTAACTCTAGTAG	CCTTAACTCTAGTAG	1	1
CTAGCGACATCGATA	CTAGCGACATCGATA	1	1
CTCTTATCCTATCAT	CTCTTATCCTATCAT	1	1
AACATGTCGTCCGCT	AACATGTCGTCCGCT	1	1
TGCACTGCTCATACT	TGCACTGCTCATACT	1	1
CTCTGGTTAGTATCA	CTCTGGTTAGTATCA	1	1
TATTTATGCTTGGTG	TATTTATGCTTGGTG	1	1
TGTTCTCGAGAAAAA	TGTTCTCGAGAAAAA	1	1
TTGTTGGAATTTTGC	TTGTTGGAATTTTGC	1	1
ATAATACGATTTACT	ATAATACGATTTACT	1	1
GTATTTGGGTTTCAT	GTATTTGGGTTTCAT	1	1
CTAGTTCAATGTCCT	CTAGTTCAATGTCCT	1	1
AGTGGTCTGCTCTTT	AGTGGTCTGCTCTTT	1	1
AATCTGCGATCGTTC	AATCTGCGATCGTTC	1	1
ATATTTTGCCTCGTT	ATATTTTGCCTCGTT	1	1
TAATGGGAAGTGCTG	TAATGGGAAGTGCTG	3	1
AGTTTGGATAAGCAT	AGTTTGGATAAGCAT	1	1
TATCGGGTCAATGTC	TATCGGGTCAATGTC	2	1
ATCCATTTACCCTCA	ATCCATTTACCCTCA	1	1
TAAAGGACACTGCTA	TAAAGGACACTGCTA	1	1
TTCAGTTCACCTCCA	TTCAGTTCACCTCCA	1	1
ATACCCATATATTAA	ATACCCATATATTAA	1	1
ACTACTGCCTCATAA	ACTACTGCCTCATAA	1	1
GCTTCTCTTTACATA	GCTTCTCTTTACATA	1	1
CTTAATAATAAATAT	CTTAATAATAAATAT	2	1
GACCTCTCACAAAAA	GACCTCTCACAAAAA	1	1
TTCTTCTGCATTCAA	TTCTTCTGCATTCAA	2	1
TATTTTTTGCCGATG	TATTTTTTGCCGATG	2	1
ATAATGTATGTCCCT	ATAATGTATGTCCCT	1	1
CGAGGTTTTTATCTT	CGAGGTTTTTATCTT	2	1
CTCAATGTTGTTGCG	CTCAATGTTGTTGCG	1	1
AATCAACCTGTCATG	AATCAACCTGTCATG	1	1
GTCCGGAGTTGAGGG	GTCCGGAGTTGAGGG	3	1
AATAGGAGATAGACC	AATAGGAGATAGACC	1	1
AAGGATTTAGGGTCT	AAGGATTTAGGGTCT	1	1
GCTCATTAGGTTCCC	GCTCATTAGGTTCCC	1	1
GGCGGATATGCTGAC	GGCGGATATGCTGAC	1	1
ATCAAGGATTCTTCT	ATCAAGGATTCTTCT	1	1
GGGTTGGGTTAGACA	GGGTTGGGTTAGACA	1	1
CGTTCACTTTCGACC	CGTTCACTTTCGACC	1	1
TATGCAGCACTTGCT	TATGCAGCACTTGCT	1	1
TCTGGATATAAGATT	TCTGGATATAAGATT	1	1
TGAGGCTCGGGGTGG	TGAGGCTCGGGGTGG	1	1
ATTGTTAGGTGCGGT	ATTGTTAGGTGCGGT	3	1
GTATATTGCCACACG	GTATATTGCCACACG	2	1
ATCGCCGGATCGGGC	ATCGCCGGATCGGGC	4	1
CGGCGTAGGCAACAT	CGGCGTAGGCAACAT	2	1
AAAGCAGTGCGGGGC	AAAGCAGTGCGGGGC	1	1
CTCTTAGTGTCTAAT	CTCTTAGTGTCTAAT	1	1
TATATTCAGTCTCAG	TATATTCAGTCTCAG	1	1
CCTACTCAATTAATC	CCTACTCAATTAATC	1	1
GGACGGGCGGCGGGG	GGACGGGCGGCGGGG	1	1
TGAGTGATCAGTGCC	TGAGTGATCAGTGCC	1	1
AAAAAGTACACGGGA	AAAAAGTACACGGGA	1	1
AAAAGCCGGGGCATT	AAAAGCCGGGGCATT	1	1
TAAAGACAGAAGAAT	TAAAGACAGAAGAAT	1	1
TTCTTTACGAATATC	TTCTTTACGAATATC	2	1
AACTTTAAATATTTA	AACTTTAAATATTTA	1	1
AACTATTCTACACCT	AACTATTCTACACCT	2	1
CAGTCCTGGGGCGTC	CAGTCCTGGGGCGTC	1	1
TGCAAGGTAATTCCA	TGCAAGGTAATTCCA	1	1
CAGGATGTACATTTG	CAGGATGTACATTTG	1	1
GAGTGGTATGCCACG	GAGTGGTATGCCACG	1	1
GTGAATATCTAACTA	GTGAATATCTAACTA	1	1
GAATTGGTACAGTTT	GAATTGGTACAGTTT	1	1
CATGAGTTTATTTCT	CATGAGTTTATTTCT	1	1
GTCTCAGCGTATTGG	GTCTCAGCGTATTGG	1	1
TCGATAAGTAATTTT	TCGATAAGTAATTTT	1	1
ATTGAAAGGTCGGGC	ATTGAAAGGTCGGGC	1	1
ACTATATAATACAAC	ACTATATAATACAAC	1	1
AGAGCATCGTTTCAT	AGAGCATCGTTTCAT	1	1
CATTACAATTACTAT	CATTACAATTACTAT	1	1
GCTGTGGGGGGACCC	GCTGTGGGGGGACCC	1	1
GTTTTTGAAATACGG	GTTTTTGAAATACGG	1	1
GTGGTTCGTCTTATT	GTGGTTCGTCTTATT	2	1
ATCATGGTCAAAATA	ATCATGGTCAAAATA	2	1
TTGAATGATGTAAAT	TTGAATGATGTAAAT	1	1
CGTGCGACCCCTCTT	CGTGCGACCCCTCTT	1	1
GATGCATAGCGCGCG	GATGCATAGCGCGCG	1	1
AATATAAATCGTATT	AATATAAATCGTATT	1	1
GCATATCTAATCGAA	GCATATCTAATCGAA	1	1
CGCAATATATCGAGG	CGCAATATATCGAGG	1	1
ACGTGAGAGGAATCG	ACGTGAGAGGAATCG	1	1
TTCTGTGCTGTCTGA	TTCTGTGCTGTCTGA	1	1
TCGGGCTTTTCACGT	TCGGGCTTTTCACGT	1	1
TTACAAAGATCATGA	TTACAAAGATCATGA	1	1
TGGAGATTCTTTTGC	TGGAGATTCTTTTGC	1	1
TATCCCACATCTAGT	TATCCCACATCTAGT	1	1
CTGACATGGTGTTTT	CTGACATGGTGTTTT	1	1
GTAGAGCATATAGGA	GTAGAGCATATAGGA	2	1
CAGAATACTCGAAAT	CAGAATACTCGAAAT	2	1
GCGTGGCGGTGGTAA	GCGTGGCGGTGGTAA	1	1
GCGGCCGTAGTGCTG	GCGGCCGTAGTGCTG	1	1
GTCATGTTCAATGGT	GTCATGTTCAATGGT	1	1
GACATCTCTAAACAC	GACATCTCTAAACAC	1	1
ATCTGTTAATTTCTA	ATCTGTTAATTTCTA	2	1
TTAATGTCAATAGCT	TTAATGTCAATAGCT	1	1
CATTAAGATTTCCTC	CATTAAGATTTCCTC	1	1
GATATTATTATCAAT	GATATTATTATCAAT	2	1
GACGAGATCGTGATA	GACGAGATCGTGATA	1	1
GGGTAAGCGCCGAGT	GGGTAAGCGCCGAGT	1	1
CAGTTTTCTTCTTTA	CAGTTTTCTTCTTTA	1	1
CGTGATGAATTAATA	CGTGATGAATTAATA	2	1
GCCCCGGTGGGTGAA	GCCCCGGTGGGTGAA	1	1
TCATGAGCAAAATCT	TCATGAGCAAAATCT	1	1
GGATAAGTCAGCTAT	GGATAAGTCAGCTAT	1	1
TACAAATATACTTCT	TACAAATATACTTCT	1	1
TTTCCATGCCACTCA	TTTCCATGCCACTCA	1	1
GGAAAGGTTAGGCAT	GGAAAGGTTAGGCAT	3	1
CCAGCTTATTCCGGT	CCAGCTTATTCCGGT	2	1
GTTTCTTGTACACTG	GTTTCTTGTACACTG	1	1
GGTGTGCTGGGTATT	GGTGTGCTGGGTATT	1	1
AGCTGTACCTATTAC	AGCTGTACCTATTAC	1	1
TCATAGGTGCGTATA	TCATAGGTGCGTATA	1	1
GTCAGATTCAATTAT	GTCAGATTCAATTAT	1	1
TTGCTTCAGGTAACG	TTGCTTCAGGTAACG	1	1
ATGCGAATTTAAGTT	ATGCGAATTTAAGTT	1	1
GATCGGGAGAATGTC	GATCGGGAGAATGTC	1	1
TTTGCAAAAGAATCT	TTTGCAAAAGAATCT	1	1
ATGCAAATATCACTT	ATGCAAATATCACTT	1	1
TTCTGGTAATCTTTC	TTCTGGTAATCTTTC	1	1
TAAAGGATCACGTTA	TAAAGGATCACGTTA	2	1
AAAAATCCAAACAAT	AAAAATCCAAACAAT	1	1
GAATAAGATTCATAC	GAATAAGATTCATAC	1	1
ACAGTCACACTATTT	ACAGTCACACTATTT	1	1
GGAATTCTCATTAAT	GGAATTCTCATTAAT	1	1
ACCGTTTCAGCATTA	ACCGTTTCAGCATTA	1	1
AACAAGTGTCTCTTT	AACAAGTGTCTCTTT	1	1
TACTTTATAAAACTA	TACTTTATAAAACTA	2	1
AGAGATTGGCCGAAT	AGAGATTGGCCGAAT	1	1
GGTGTTGCATCGTGT	GGTGTTGCATCGTGT	2	1
TCGTAACTACTTATC	TCGTAACTACTTATC	2	1
AACTTTGAACAAATC	AACTTTGAACAAATC	2	1
CATGGACCCTATGTA	CATGGACCCTATGTA	1	1
TATCATTTTGCGTTT	TATCATTTTGCGTTT	1	1
GGGGAGAGGAGGGGA	GGGGAGAGGAGGGGA	1	1
GAAGATAAAATTTCT	GAAGATAAAATTTCT	2	1
TATTCGTTAACTTTT	TATTCGTTAACTTTT	2	1
TTAAGTTAGACATGG	TTAAGTTAGACATGG	1	1
GATGCTTCGCTAATG	GATGCTTCGCTAATG	1	1
AGTTTATTGTGTGCA	AGTTTATTGTGTGCA	1	1
TTACTTGTGTGCCTT	TTACTTGTGTGCCTT	1	1
TCTTCTCATGTCCTA	TCTTCTCATGTCCTA	1	1
TCTACCCTTTTCTTC	TCTACCCTTTTCTTC	1	1
TCGTTGTCGGCACAT	TCGTTGTCGGCACAT	1	1
CCCTGGGCAAAAGAA	CCCTGGGCAAAAGAA	1	1
GTTTTCCGCTTTTCT	GTTTTCCGCTTTTCT	1	1
TACCTTTGCCAAGAA	TACCTTTGCCAAGAA	2	1
ACCTTACAGTAGTGT	ACCTTACAGTAGTGT	1	1
GCCAGATTTGTAGAG	GCCAGATTTGTAGAG	1	1
AAATACTACTCCTAC	AAATACTACTCCTAC	2	1
ACGCCTCTGCTTAGC	ACGCCTCTGCTTAGC	1	1
TAACGAGTAAGTCTT	TAACGAGTAAGTCTT	1	1
CACATGTACGTAGCT	CACATGTACGTAGCT	1	1
ATTGTGTATAAATTG	ATTGTGTATAAATTG	1	1
GGCGGGGGTTGCTGT	GGCGGGGGTTGCTGT	1	1
CCTTAATTCCATTAG	CCTTAATTCCATTAG	1	1
ACAATCTTTGTTACG	ACAATCTTTGTTACG	1	1
TTAGGGTAACGCTTT	TTAGGGTAACGCTTT	1	1
CGGCTTGAGCTTACT	CGGCTTGAGCTTACT	1	1
CATCGGGTTTCGCCA	CATCGGGTTTCGCCA	1	1
GCATGGGGCGGTGGG	GCATGGGGCGGTGGG	4	1
TACACTGTGGCAAAC	TACACTGTGGCAAAC	3	1
TACCAGGATCTCAGA	TACCAGGATCTCAGA	1	1
GTCCACGCGATCTTA	GTCCACGCGATCTTA	1	1
AGGAGGGCAGGCCGG	AGGAGGGCAGGCCGG	1	1
GAGCCGTTTTAGGGG	GAGCCGTTTTAGGGG	1	1
GGGTTTGAGCATTTA	GGGTTTGAGCATTTA	1	1
CGCATGTAGGATGCG	CGCATGTAGGATGCG	1	1
TCTGGTGGCGGCGGA	TCTGGTGGCGGCGGA	1	1
CTTAAACGCTCGCCG	CTTAAACGCTCGCCG	1	1
TTTGATCTATCAGAA	TTTGATCTATCAGAA	1	1
GTATTCAAGTTGTAC	GTATTCAAGTTGTAC	5	1
TTAAGTGGTATTATG	TTAAGTGGTATTATG	1	1
TTCGAGTCAGGGGTT	TTCGAGTCAGGGGTT	1	1
TGTAGCGTTACCTCA	TGTAGCGTTACCTCA	1	1
TATGTTATATACTCT	TATGTTATATACTCT	1	1
GGTCTAACTATGGTC	GGTCTAACTATGGTC	1	1
TCTATACTAGTGCGC	TCTATACTAGTGCGC	1	1
TGATCAGTACACTGA	TGATCAGTACACTGA	1	1
GGTCGGTTAGCTACT	GGTCGGTTAGCTACT	1	1
GGTTAAAGAGAGAGG	GGTTAAAGAGAGAGG	1	1
TCACACGCTGTGTAG	TCACACGCTGTGTAG	1	1
AGATGGGGGTGGGCG	AGATGGGGGTGGGCG	1	1
GGAATAGGGGATCAT	GGAATAGGGGATCAT	1	1
GGGTGGAGGAGTTTC	GGGTGGAGGAGTTTC	1	1
AAATCACTTGAGCTT	AAATCACTTGAGCTT	1	1
TTCCGGAAAGTTTAA	TTCCGGAAAGTTTAA	1	1
TGTTGGGGTGCATAA	TGTTGGGGTGCATAA	1	1
TAAGACATTCGACTT	TAAGACATTCGACTT	1	1
GCTTGCGGATTTAAC	GCTTGCGGATTTAAC	1	1
CAGGTTGCAACCAAA	CAGGTTGCAACCAAA	1	1
ATGGTGTAACATGAC	ATGGTGTAACATGAC	1	1
GGTACATCACGATAA	GGTACATCACGATAA	1	1
TTTTTTTAAAGTGGG	TTTTTTTAAAGTGGG	1	1
TTCGTCCTGGCTACT	TTCGTCCTGGCTACT	1	1
CATAAGTCTAATGTC	CATAAGTCTAATGTC	1	1
TGATGCGATGTAAAT	TGATGCGATGTAAAT	1	1
TAAAGCGATTTTTCA	TAAAGCGATTTTTCA	1	1
CCGGGCGCTTGGAAG	CCGGGCGCTTGGAAG	2	1
GCTCTTCTCTTTTTG	GCTCTTCTCTTTTTG	1	1
CAATGTATAGCAAGT	CAATGTATAGCAAGT	1	1
CTTATTGCTTTACAT	CTTATTGCTTTACAT	1	1
TATATGCCTTTCTGA	TATATGCCTTTCTGA	2	1
GGGAAAACTGAGTTA	GGGAAAACTGAGTTA	1	1
GTATACACACCGAAT	GTATACACACCGAAT	1	1
CACAATCGGTCGTTA	CACAATCGGTCGTTA	1	1
GTTGGGGTGGGGGAG	GTTGGGGTGGGGGAG	1	1
TAATTCTTAATTATC	TAATTCTTAATTATC	1	1
TCGGAATGGTGTGTG	TCGGAATGGTGTGTG	1	1
TAAGTTACTCAGTGG	TAAGTTACTCAGTGG	1	1
TCATCGGTACTTTTT	TCATCGGTACTTTTT	1	1
ACTCTTTGCTCTCCT	ACTCTTTGCTCTCCT	1	1
TTTCACGGATTTTTC	TTTCACGGATTTTTC	1	1
ACGTGTTTTTCAATC	ACGTGTTTTTCAATC	3	1
GGCTGGGTTAATGCG	GGCTGGGTTAATGCG	1	1
TAAAAAGGCGTAGTC	TAAAAAGGCGTAGTC	2	1
CATGCTCGCTCTACT	CATGCTCGCTCTACT	1	1
GAGGCTATGGGTTTT	GAGGCTATGGGTTTT	1	1
TAGTACAGTCTGTGG	TAGTACAGTCTGTGG	1	1
TTAACATACGTAGTG	TTAACATACGTAGTG	1	1
GAATATCACCAATTT	GAATATCACCAATTT	1	1
GCAAGCTACTGCTTT	GCAAGCTACTGCTTT	1	1
CATCGGGCGGAAGCT	CATCGGGCGGAAGCT	2	1
GAATGGATTCAAGGT	GAATGGATTCAAGGT	2	1
ATGCTACCAATGTGT	ATGCTACCAATGTGT	1	1
GATATAATTTTTTGC	GATATAATTTTTTGC	2	1
GATCGAGAGACACGT	GATCGAGAGACACGT	1	1
GTCCATACCAATGAA	GTCCATACCAATGAA	1	1
CTATACATCGATTTC	CTATACATCGATTTC	3	1
TCTTTCGAATTATCT	TCTTTCGAATTATCT	1	1
TAGGAGTTTTCGATT	TAGGAGTTTTCGATT	1	1
CGGTATTGGTGGGGA	CGGTATTGGTGGGGA	1	1
ATCGGTACATGTGTT	ATCGGTACATGTGTT	1	1
GGCGGGGGACGGGGG	GGCGGGGGACGGGGG	1	1
CATCGTCGCTTTTGG	CATCGTCGCTTTTGG	1	1
AACCTAAAGTTGATT	AACCTAAAGTTGATT	1	1
ATGGTCACTTTCTAT	ATGGTCACTTTCTAT	1	1
TATGGGTCAGCTCAT	TATGGGTCAGCTCAT	1	1
CCGTTAGGCGAGTAT	CCGTTAGGCGAGTAT	1	1
ATTGAAGATACTTCA	ATTGAAGATACTTCA	1	1
TCAATGCGGGCCCGC	TCAATGCGGGCCCGC	1	1
AACAATGTGGTAGTG	AACAATGTGGTAGTG	1	1
TCTGGGATTTTAAGT	TCTGGGATTTTAAGT	1	1
TGGACGGAGTCCAGT	TGGACGGAGTCCAGT	1	1
TGACAATCGCTGTGT	TGACAATCGCTGTGT	1	1
GTAGTGAAACGTTGA	GTAGTGAAACGTTGA	1	1
GGCTACTTCACTTTT	GGCTACTTCACTTTT	1	1
ATTTGAGTTATAAAC	ATTTGAGTTATAAAC	1	1
ACAAAGGTCATTGTA	ACAAAGGTCATTGTA	1	1
CTCGTCCTTTTATTA	CTCGTCCTTTTATTA	1	1
ACAGGTGCGTTCATC	ACAGGTGCGTTCATC	1	1
TGATCGGGGCTATGT	TGATCGGGGCTATGT	1	1
GCTCGGGGGTCGGGA	GCTCGGGGGTCGGGA	1	1
CTTGACGGTGTGTTT	CTTGACGGTGTGTTT	2	1
GGAAGGAGCTCGTCC	GGAAGGAGCTCGTCC	2	1
TCGTGTAATGATAAT	TCGTGTAATGATAAT	1	1
GACACAGCATTATTT	GACACAGCATTATTT	1	1
TTCGCTTTGTAATGT	TTCGCTTTGTAATGT	2	1
TTGATGTTGTTATAC	TTGATGTTGTTATAC	1	1
ATATGTTGCTGTAAC	ATATGTTGCTGTAAC	4	1
GTCACAATAATCAAG	GTCACAATAATCAAG	1	1
TCAATCACGAAATGG	TCAATCACGAAATGG	1	1
TAGTTCTGGTCGGCT	TAGTTCTGGTCGGCT	1	1
CGCACTTCTTCGCTA	CGCACTTCTTCGCTA	1	1
CAATAAGGCAAATGT	CAATAAGGCAAATGT	1	1
AATAGAGGATTTTCG	AATAGAGGATTTTCG	1	1
AAGTCCTTCAATTTA	AAGTCCTTCAATTTA	1	1
ATACGGAGTATCGTG	ATACGGAGTATCGTG	1	1
CCTGTAGGGCTTTAA	CCTGTAGGGCTTTAA	1	1
CAGCGAATTAAGTCG	CAGCGAATTAAGTCG	1	1
TTTTTTATGGAAAAT	TTTTTTATGGAAAAT	1	1
TGAAGCGTGGTATTT	TGAAGCGTGGTATTT	1	1
TATCATCATTACGAG	TATCATCATTACGAG	1	1
AATTTGGTTTGTAGT	AATTTGGTTTGTAGT	1	1
TTTATTTGACCTATA	TTTATTTGACCTATA	1	1
CCTAAGCAATACGTT	CCTAAGCAATACGTT	1	1
TTTTTTGCGCGGGTT	TTTTTTGCGCGGGTT	1	1
TGGGGGCAAGCTTTG	TGGGGGCAAGCTTTG	2	1
AGAGCGTCCGATTGT	AGAGCGTCCGATTGT	1	1
GCGATGGGTGGGCGC	GCGATGGGTGGGCGC	1	1
TAAGTCTACTTCACT	TAAGTCTACTTCACT	1	1
TATAAGCTGTACTTA	TATAAGCTGTACTTA	1	1
GGGCGCGCGGGGGGG	GGGCGCGCGGGGGGG	1	1
ACAATATAGTATACG	ACAATATAGTATACG	1	1
ATATTGGATCTGCGT	ATATTGGATCTGCGT	1	1
GAATTTGTAGTCGTT	GAATTTGTAGTCGTT	1	1
AGTTGCTTCGCAAAT	AGTTGCTTCGCAAAT	1	1
GACTAACTTTTTCTT	GACTAACTTTTTCTT	1	1
CACTACCATCTTGAT	CACTACCATCTTGAT	1	1
TGATCGAATTTTGCA	TGATCGAATTTTGCA	2	1
ATGTGATTTTAATCG	ATGTGATTTTAATCG	2	1
GAGATGCGGGGGGGG	GAGATGCGGGGGGGG	1	1
TAAGCTCAGTGTCGT	TAAGCTCAGTGTCGT	2	1
GCTGTAGTAAAAAAT	GCTGTAGTAAAAAAT	1	1
CTCCTGCATTTTGAG	CTCCTGCATTTTGAG	1	1
TCCCAGTGACCTTGT	TCCCAGTGACCTTGT	1	1
TACTCTTCTTTAATA	TACTCTTCTTTAATA	1	1
GGCTTGGGCTGGAGG	GGCTTGGGCTGGAGG	1	1
CAGGTAATGTTACAT	CAGGTAATGTTACAT	1	1
AACGTTATGGACCAT	AACGTTATGGACCAT	1	1
GGCTGTTGAGCTTCG	GGCTGTTGAGCTTCG	1	1
GCCGTATCTGTAACT	GCCGTATCTGTAACT	1	1
TATCTGCTTCAGTCT	TATCTGCTTCAGTCT	1	1
TTAGCTCTCCGGGGC	TTAGCTCTCCGGGGC	1	1
GAGTATGCCATGAGT	GAGTATGCCATGAGT	1	1
CCTGAGCGGACTATA	CCTGAGCGGACTATA	1	1
GGTCCTTCCTAATTT	GGTCCTTCCTAATTT	1	1
TAATGGATTTCTGGG	TAATGGATTTCTGGG	1	1
TGTACTCATTTGTTA	TGTACTCATTTGTTA	1	1
TTGTTCATTATCCCA	TTGTTCATTATCCCA	1	1
TGAACTTCTCCTTTA	TGAACTTCTCCTTTA	1	1
GCGCGCATTAGTCTC	GCGCGCATTAGTCTC	1	1
ATTTCATAAGCCTCA	ATTTCATAAGCCTCA	2	1
TCTAACCACTCTGCA	TCTAACCACTCTGCA	2	1
TTTCAGTTTCCATCT	TTTCAGTTTCCATCT	1	1
GCCATTGGACATGTG	GCCATTGGACATGTG	2	1
GCTTAACTTATGCTA	GCTTAACTTATGCTA	1	1
TTCGATTTTACGCGA	TTCGATTTTACGCGA	1	1
CAGAAATGACCAGTC	CAGAAATGACCAGTC	1	1
GTTCTGTTCTTTATA	GTTCTGTTCTTTATA	3	1
TTTGGCTGTGAGGTG	TTTGGCTGTGAGGTG	1	1
GATTTGAACGGATCT	GATTTGAACGGATCT	1	1
GTGGCCTGGTTCACA	GTGGCCTGGTTCACA	1	1
ATTCGTGCTCTGGTT	ATTCGTGCTCTGGTT	1	1
GATTCGAAGTGTATG	GATTCGAAGTGTATG	1	1
TTGCCTGGAGATTGA	TTGCCTGGAGATTGA	1	1
TAATTCAAGGTAAGT	TAATTCAAGGTAAGT	1	1
CTATAACTCTACGGT	CTATAACTCTACGGT	1	1
TAACACGGAAAGGCT	TAACACGGAAAGGCT	1	1
TCCATCATCTTACCT	TCCATCATCTTACCT	1	1
GGGTAGAACGGAGGG	GGGTAGAACGGAGGG	1	1
TATACGATGTACTTA	TATACGATGTACTTA	1	1
TCAAAGGTTATAGAA	TCAAAGGTTATAGAA	1	1
TTGGGTTGGCGGCGT	TTGGGTTGGCGGCGT	1	1
TCTGGATTTATCATA	TCTGGATTTATCATA	1	1
CAATAGGGTGAGGTA	CAATAGGGTGAGGTA	4	1
TACCTATGCACGAAA	TACCTATGCACGAAA	2	1
TTGTTAGTGCGGGGA	TTGTTAGTGCGGGGA	1	1
GTATCACATATTGTC	GTATCACATATTGTC	1	1
GCAGCGAAAGCTAAA	GCAGCGAAAGCTAAA	4	1
AAATGCTCATCTTTA	AAATGCTCATCTTTA	1	1
TTTGGATTTATAATG	TTTGGATTTATAATG	1	1
GTGAATCGTTGGAGG	GTGAATCGTTGGAGG	2	1
GCGTTCGCAGTCGTG	GCGTTCGCAGTCGTG	1	1
TAAATGTGATACTAT	TAAATGTGATACTAT	1	1
TACGGTCTTTATTAA	TACGGTCTTTATTAA	1	1
ATCCTCAGGAGGAAC	ATCCTCAGGAGGAAC	1	1
GGAACAGTTTAGCAG	GGAACAGTTTAGCAG	1	1
ACCGTGATTTGGGAA	ACCGTGATTTGGGAA	1	1
GAGTGCCTTTCTTTT	GAGTGCCTTTCTTTT	1	1
ACTCAAGTTGATCGG	ACTCAAGTTGATCGG	2	1
CTATGAACCTATTTT	CTATGAACCTATTTT	1	1
TCCGTGATGCTGTAG	TCCGTGATGCTGTAG	1	1
GTAAAGATTTGTCTA	GTAAAGATTTGTCTA	1	1
TTGAAGGCGAGGTCT	TTGAAGGCGAGGTCT	1	1
TAAGTAAATATAGTC	TAAGTAAATATAGTC	1	1
CGTTTAGTGCCTTGA	CGTTTAGTGCCTTGA	1	1
TGTACCGGGTTGGTT	TGTACCGGGTTGGTT	1	1
TGTTGTTGTGCCGTA	TGTTGTTGTGCCGTA	1	1
CATAATGGCGATATA	CATAATGGCGATATA	2	1
TTTGATGTGAAATTT	TTTGATGTGAAATTT	1	1
GCTAGCGGTAAATAA	GCTAGCGGTAAATAA	1	1
TTTTCGGCTTTCATA	TTTTCGGCTTTCATA	1	1
CGACTATCTCACATT	CGACTATCTCACATT	1	1
TTAATACGTTCTGTG	TTAATACGTTCTGTG	1	1
TTCAAACCTAATGGA	TTCAAACCTAATGGA	2	1
TCTATATCGTAAGAT	TCTATATCGTAAGAT	1	1
ACATGGAGGTGGTCC	ACATGGAGGTGGTCC	1	1
GACTGGCAGAATATA	GACTGGCAGAATATA	1	1
TTAGGGGCTCTTCTC	TTAGGGGCTCTTCTC	1	1
CATTAAATATTCGTT	CATTAAATATTCGTT	1	1
GATTGATGATGGTCT	GATTGATGATGGTCT	1	1
TCAATCAAAAGTGTC	TCAATCAAAAGTGTC	1	1
CTTCCCGTGTTGACA	CTTCCCGTGTTGACA	1	1
GGACGGGGGAGTTGG	GGACGGGGGAGTTGG	1	1
CGAGTTGAGGCTTAT	CGAGTTGAGGCTTAT	1	1
TGGTGCCTTGTATTC	TGGTGCCTTGTATTC	1	1
CGTTGAAGCAATTAA	CGTTGAAGCAATTAA	1	1
ACTTACATGAGAAAT	ACTTACATGAGAAAT	2	1
TCCCCGGTGGGTGAA	TCCCCGGTGGGTGAA	1	1
ATTAGAGCGCTCCGT	ATTAGAGCGCTCCGT	1	1
AGCGTGGGGGGTGTG	AGCGTGGGGGGTGTG	1	1
GGGTTGTGTGGTGCG	GGGTTGTGTGGTGCG	1	1
TTTAACACTGGTATT	TTTAACACTGGTATT	1	1
GTCGATCTCTTGAAT	GTCGATCTCTTGAAT	1	1
TTTTCTAAAGGATCT	TTTTCTAAAGGATCT	1	1
CATCTCTCATTGCTC	CATCTCTCATTGCTC	1	1
AGTTTAGTTTCGCAA	AGTTTAGTTTCGCAA	1	1
GTATGCTAAACGTAC	GTATGCTAAACGTAC	1	1
ATAGTTTAACCTTAT	ATAGTTTAACCTTAT	1	1
AATATGTAAATTCAT	AATATGTAAATTCAT	1	1
ATTGTGGATAAATTG	ATTGTGGATAAATTG	2	1
CTATTAGGGTATAAT	CTATTAGGGTATAAT	1	1
ACTATGACGTCTATA	ACTATGACGTCTATA	1	1
TAAGAATCTATTTGA	TAAGAATCTATTTGA	1	1
TATGTTATATATGTT	TATGTTATATATGTT	1	1
TCGTTTATGGTCCTT	TCGTTTATGGTCCTT	1	1
GTGGGCTCTATAATT	GTGGGCTCTATAATT	1	1
GGACTGACCGTGTAA	GGACTGACCGTGTAA	2	1
TTAGCACGGGTATGA	TTAGCACGGGTATGA	1	1
TGAAGTCTGGTAATC	TGAAGTCTGGTAATC	1	1
ACTATGGCTGTGAGA	ACTATGGCTGTGAGA	1	1
AAATTTCGGCATCTT	AAATTTCGGCATCTT	1	1
ATTTCGCCTGTGGTC	ATTTCGCCTGTGGTC	1	1
CAATTCTGTCAGATT	CAATTCTGTCAGATT	2	1
TAGGTTAGTACACTT	TAGGTTAGTACACTT	3	1
AAGAGGTGTTATATT	AAGAGGTGTTATATT	1	1
ACAATCTTGTAGTGC	ACAATCTTGTAGTGC	2	1
ATTCTCAAACATGTT	ATTCTCAAACATGTT	1	1
TGTGTTCCTAGGGTT	TGTGTTCCTAGGGTT	2	1
TGTAATTTGTACACG	TGTAATTTGTACACG	2	1
GTCGAGCCCATGGGA	GTCGAGCCCATGGGA	1	1
CATGTGTATTACTAT	CATGTGTATTACTAT	2	1
TCATTTATCATCCTA	TCATTTATCATCCTA	1	1
AAATAAGGCTCAAAT	AAATAAGGCTCAAAT	1	1
AAGTGCACTATCTCG	AAGTGCACTATCTCG	1	1
ACGCGGAGCGAAGGT	ACGCGGAGCGAAGGT	1	1
GGATCTTTAACTGCT	GGATCTTTAACTGCT	1	1
GACATGGGTGGGGGG	GACATGGGTGGGGGG	1	1
GCGGTCGGGGTTTTG	GCGGTCGGGGTTTTG	1	1
TTTACGTCTAAACTT	TTTACGTCTAAACTT	1	1
CGCAACTTAATTTGC	CGCAACTTAATTTGC	1	1
CGTAAAGGATGCACT	CGTAAAGGATGCACT	1	1
TACTCGCACTCTTTT	TACTCGCACTCTTTT	1	1
TATGAAAATGCCCTT	TATGAAAATGCCCTT	2	1
GTCTAAATTCAATCT	GTCTAAATTCAATCT	1	1
GCTCTTTTATTTGTT	GCTCTTTTATTTGTT	1	1
CGCTCGCCCTTGGAT	CGCTCGCCCTTGGAT	1	1
CTTTCTCCTACTTTA	CTTTCTCCTACTTTA	1	1
GTGAATACTTTTGAC	GTGAATACTTTTGAC	1	1
GGACTTGTAGAAGAT	GGACTTGTAGAAGAT	1	1
GGAGGCTACATTGTC	GGAGGCTACATTGTC	1	1
TCACGACTCAAGACC	TCACGACTCAAGACC	2	1
TTCGCTTCTTAAACG	TTCGCTTCTTAAACG	1	1
GATGAACTTATAGCT	GATGAACTTATAGCT	1	1
CTATCCTTTCTTGCT	CTATCCTTTCTTGCT	1	1
CAGTGTCTTTTCCTT	CAGTGTCTTTTCCTT	1	1
CTTTTTATATAGTTA	CTTTTTATATAGTTA	2	1
GTACGGTGCGATATA	GTACGGTGCGATATA	1	1
GGCGGGACTGTTGGG	GGCGGGACTGTTGGG	1	1
TGTCGGCCTGGCGAT	TGTCGGCCTGGCGAT	1	1
ATCATTGTAACATTA	ATCATTGTAACATTA	1	1
TACAACCTATGTTTC	TACAACCTATGTTTC	1	1
ATAAATTTAGAATTC	ATAAATTTAGAATTC	1	1
ACAGAAGCTAAACTC	ACAGAAGCTAAACTC	1	1
ACATATCGCTCACGT	ACATATCGCTCACGT	1	1
CATGGCAAGTTTGTT	CATGGCAAGTTTGTT	1	1
CTAAATATACGCGTT	CTAAATATACGCGTT	1	1
AATTAGATTAAACGT	AATTAGATTAAACGT	1	1
TAGGCGCGTGGACGC	TAGGCGCGTGGACGC	1	1
TTAGTACTAATCAGG	TTAGTACTAATCAGG	2	1
CTAGATGATCAGTTG	CTAGATGATCAGTTG	1	1
GCGGGGAGGAGCCTG	GCGGGGAGGAGCCTG	1	1
ATTGTCTTTGTGTCC	ATTGTCTTTGTGTCC	1	1
GTGTGCCGCGTTTGT	GTGTGCCGCGTTTGT	1	1
CTAGGGTAGGCACTT	CTAGGGTAGGCACTT	2	1
GGTGTCGGCGTGTCG	GGTGTCGGCGTGTCG	1	1
TGAAACATTGTTCAC	TGAAACATTGTTCAC	1	1
TGCCATTCTAACATT	TGCCATTCTAACATT	1	1
TGGACGATACCCTTA	TGGACGATACCCTTA	1	1
GATTACCTAATGGTT	GATTACCTAATGGTT	1	1
ATCACCTAGGTCTAA	ATCACCTAGGTCTAA	1	1
ACTCCAGGCTGGTCT	ACTCCAGGCTGGTCT	1	1
TACTGGCCTTAAAAG	TACTGGCCTTAAAAG	1	1
CATTAGGTGTTCGTT	CATTAGGTGTTCGTT	1	1
ATGTTAAAATCGTCG	ATGTTAAAATCGTCG	1	1
AAGAGTAGCTAAATT	AAGAGTAGCTAAATT	1	1
TCCTTCCGTGGGGAT	TCCTTCCGTGGGGAT	1	1
TGTACCGCTCGCATA	TGTACCGCTCGCATA	3	1
GTAGACAGTAATGGT	GTAGACAGTAATGGT	1	1
TGATGACTAATTAGT	TGATGACTAATTAGT	1	1
TCTTTCGGAGTGAAT	TCTTTCGGAGTGAAT	1	1
TTAGTGTGAATGGGT	TTAGTGTGAATGGGT	1	1
CGGAGAGCCTGTGGA	CGGAGAGCCTGTGGA	1	1
GGACGCGATTTACGA	GGACGCGATTTACGA	2	1
GTCTGTGAGTCGAGG	GTCTGTGAGTCGAGG	1	1
GTCCTATATAGGAGC	GTCCTATATAGGAGC	1	1
CCAATTTCTACCTCT	CCAATTTCTACCTCT	1	1
TATTGTGACCTTTTT	TATTGTGACCTTTTT	1	1
AAATGAGAATTATTG	AAATGAGAATTATTG	1	1
AATGTGGTGGGGTAG	AATGTGGTGGGGTAG	2	1
TAAATCGTCGATGTT	TAAATCGTCGATGTT	1	1
CGTTAGATCGTTCAC	CGTTAGATCGTTCAC	1	1
TTCGTTTTGTACTTA	TTCGTTTTGTACTTA	1	1
ATCCTTGTAGGTAAT	ATCCTTGTAGGTAAT	2	1
TCCTCGTTAGTGTCA	TCCTCGTTAGTGTCA	1	1
GAAGTCCTCATTTAT	GAAGTCCTCATTTAT	1	1
CCTTGAGTAGACGTT	CCTTGAGTAGACGTT	1	1
TGGGCGGACGTGTCC	TGGGCGGACGTGTCC	2	1
TGTCCCTTGACATCA	TGTCCCTTGACATCA	1	1
TATATATTATCTTCT	TATATATTATCTTCT	1	1
ACCTGACCCCCATTT	ACCTGACCCCCATTT	1	1
AGGACGGTTTCTAAA	AGGACGGTTTCTAAA	1	1
TGCAACCTGTTGTTT	TGCAACCTGTTGTTT	1	1
TGTATAAGGCTCATG	TGTATAAGGCTCATG	1	1
ACCATTACTCTCTCG	ACCATTACTCTCTCG	1	1
CTCGTTCGGAGTATA	CTCGTTCGGAGTATA	1	1
CATAATCTGTTGCAC	CATAATCTGTTGCAC	1	1
TCAAGTTAGTCTAAT	TCAAGTTAGTCTAAT	2	1
ATCCGCGCAATAATT	ATCCGCGCAATAATT	1	1
GTTTTCCTCTATAAA	GTTTTCCTCTATAAA	1	1
CCTATCGAAGGACTT	CCTATCGAAGGACTT	1	1
TGATTGCAACTGTTT	TGATTGCAACTGTTT	2	1
TTCTTTTCGTAAGTC	TTCTTTTCGTAAGTC	1	1
TGTTCGCGAATGTAT	TGTTCGCGAATGTAT	1	1
ATAGGAGCCGTACTT	ATAGGAGCCGTACTT	1	1
TCTGCCCGCTTCGGA	TCTGCCCGCTTCGGA	1	1
TCGCTATTAACTGTT	TCGCTATTAACTGTT	1	1
CAATATAAAGTGGCA	CAATATAAAGTGGCA	1	1
AGAGAAACCTGTCTA	AGAGAAACCTGTCTA	2	1
CATAAACGTTTTTGT	CATAAACGTTTTTGT	1	1
ATATCAAAGGCCCAA	ATATCAAAGGCCCAA	1	1
TGCTGAATGACTGTT	TGCTGAATGACTGTT	1	1
ACACCAAAATCGAAG	ACACCAAAATCGAAG	2	1
TTAAACGTCCAGCAT	TTAAACGTCCAGCAT	2	1
CTAACATGCAACGTA	CTAACATGCAACGTA	2	1
TTTATACCCATAGAG	TTTATACCCATAGAG	2	1
AAACTGGGTTCTAGC	AAACTGGGTTCTAGC	2	1
TGGTGGGAAGGTTCG	TGGTGGGAAGGTTCG	1	1
GGTTGGTTGTGATTT	GGTTGGTTGTGATTT	1	1
GACTGGCTTTTGGTT	GACTGGCTTTTGGTT	1	1
CATTGTGTGTGTGGG	CATTGTGTGTGTGGG	1	1
GTTAAGGAATCTCAT	GTTAAGGAATCTCAT	1	1
AAAATAAGATTCTTT	AAAATAAGATTCTTT	3	1
GGGTACTAAATGTCT	GGGTACTAAATGTCT	1	1
TGTTTCGTTACCGTC	TGTTTCGTTACCGTC	1	1
AATTGGTTCATTGTA	AATTGGTTCATTGTA	1	1
ACTTGGCCTGATTCT	ACTTGGCCTGATTCT	1	1
CCGTCAGTAGGGCGT	CCGTCAGTAGGGCGT	1	1
AGTTAGTAAAATCAT	AGTTAGTAAAATCAT	1	1
TGTATCAAGATCTTC	TGTATCAAGATCTTC	1	1
TCAGAAAAGGGGGCT	TCAGAAAAGGGGGCT	1	1
GATAAAACTGCACAT	GATAAAACTGCACAT	1	1
ATACGTTACTCAATT	ATACGTTACTCAATT	1	1
ATGGCGAATCGTCAA	ATGGCGAATCGTCAA	1	1
ATGGTCAGCCCATGT	ATGGTCAGCCCATGT	1	1
TGGTACAACATTAGA	TGGTACAACATTAGA	1	1
AATCGTTAAGCTACT	AATCGTTAAGCTACT	1	1
TCTCAGGTTTTGCTG	TCTCAGGTTTTGCTG	3	1
GCGAGCGCGAGGGAT	GCGAGCGCGAGGGAT	2	1
CAAGGACGTAGTATG	CAAGGACGTAGTATG	1	1
TCTATGGTGAGGTTG	TCTATGGTGAGGTTG	1	1
TTTGCGCTCTCAGGT	TTTGCGCTCTCAGGT	1	1
TTTCTTTATTCTACG	TTTCTTTATTCTACG	1	1
AGTACTCTCTAAAGG	AGTACTCTCTAAAGG	1	1
CGATCAATTCATTTA	CGATCAATTCATTTA	2	1
TTTCTGCACTGATGT	TTTCTGCACTGATGT	1	1
TCTGTAAAACAGAAA	TCTGTAAAACAGAAA	1	1
CGTTTGTGCATATCT	CGTTTGTGCATATCT	1	1
AGCGACTGACCTTTG	AGCGACTGACCTTTG	1	1
TATTTTTTGTTGATC	TATTTTTTGTTGATC	1	1
GACTTGAAGTCCGTT	GACTTGAAGTCCGTT	1	1
ACCCTCAACTGGTTA	ACCCTCAACTGGTTA	1	1
AAATCTCTAGCTGTA	AAATCTCTAGCTGTA	1	1
CGTGATGGTTGAGAA	CGTGATGGTTGAGAA	1	1
TGCATTCAAAAACCA	TGCATTCAAAAACCA	1	1
TTTAGTGCATTTCTT	TTTAGTGCATTTCTT	1	1
GCTTACGAGTTTTGC	GCTTACGAGTTTTGC	3	1
TTCATACGTTATTAA	TTCATACGTTATTAA	1	1
CGCTCGGATGGCCGT	CGCTCGGATGGCCGT	1	1
AACTCATAGCCTTTT	AACTCATAGCCTTTT	1	1
GCTGCGTTCGGAATT	GCTGCGTTCGGAATT	1	1
GATTACCTATAATCT	GATTACCTATAATCT	1	1
GACTAGCTCATGCTT	GACTAGCTCATGCTT	1	1
GGGAGGCCACTACTT	GGGAGGCCACTACTT	3	1
CTTCTATTAGTCTAT	CTTCTATTAGTCTAT	1	1
CAGATCGCTAGAGCT	CAGATCGCTAGAGCT	1	1
GGCTGTGTTAGCCTC	GGCTGTGTTAGCCTC	1	1
GATCGCCTTTGCTAT	GATCGCCTTTGCTAT	1	1
AAAATTCGTGTATAT	AAAATTCGTGTATAT	1	1
CAGGCTATTGGTGTG	CAGGCTATTGGTGTG	1	1
TGTTCTTTGCGAAAC	TGTTCTTTGCGAAAC	1	1
ATACGGATAATATAC	ATACGGATAATATAC	2	1
GTATCTCCAGGTGGG	GTATCTCCAGGTGGG	1	1
GGAGGGGGAGCGGAA	GGAGGGGGAGCGGAA	1	1
AACCGCCGTGAATAA	AACCGCCGTGAATAA	1	1
CAACCACAACTCTTT	CAACCACAACTCTTT	1	1
GAAAGATCTTATTTC	GAAAGATCTTATTTC	1	1
GTCCCTATGTGCGCC	GTCCCTATGTGCGCC	1	1
GATTAATGCTTATTG	GATTAATGCTTATTG	1	1
TCTTTGTTAAGATGT	TCTTTGTTAAGATGT	1	1
ATTCGGGATTAGTGG	ATTCGGGATTAGTGG	1	1
GTTTTCTGGGGTCAA	GTTTTCTGGGGTCAA	1	1
GAAAAGCTGAGGATT	GAAAAGCTGAGGATT	1	1
TAACACCGCTCCCAG	TAACACCGCTCCCAG	1	1
GGGTCCGGGGATATG	GGGTCCGGGGATATG	1	1
GTAGTAAGTGTGCAC	GTAGTAAGTGTGCAC	1	1
GGGGGGTGAGCGGTG	GGGGGGTGAGCGGTG	1	1
ACAGGGCTAGCTTTA	ACAGGGCTAGCTTTA	2	1
TGTCCACAAACGTCA	TGTCCACAAACGTCA	1	1
CGGCCTAGGTCTCTC	CGGCCTAGGTCTCTC	1	1
TTGTATGTGGGTGAT	TTGTATGTGGGTGAT	1	1
CGCGGTAGAGTTTAT	CGCGGTAGAGTTTAT	1	1
GGGGTTCTATTGTGT	GGGGTTCTATTGTGT	1	1
AGAGCGTGTTATCTA	AGAGCGTGTTATCTA	1	1
CAAATCCGCCGCAGG	CAAATCCGCCGCAGG	1	1
ATTAGCGTCTTTTTC	ATTAGCGTCTTTTTC	1	1
CGTGTTTCGTATGTG	CGTGTTTCGTATGTG	1	1
GTAAGTTGCATAAGA	GTAAGTTGCATAAGA	1	1
AAATTAACCGCAATT	AAATTAACCGCAATT	1	1
CTTCACAGAAGTAAT	CTTCACAGAAGTAAT	1	1
GTCTACGTCGGCTAT	GTCTACGTCGGCTAT	1	1
ATTGAGGTCGCTCCT	ATTGAGGTCGCTCCT	1	1
ATAATAAAATTGATC	ATAATAAAATTGATC	1	1
TTTTAAGCTCTGTTC	TTTTAAGCTCTGTTC	1	1
TTTATCCACAGACTA	TTTATCCACAGACTA	1	1
TGGTTTCAAGAAAGT	TGGTTTCAAGAAAGT	1	1
GACATGTATTTAGAA	GACATGTATTTAGAA	1	1
GGTGTTACGACTGAA	GGTGTTACGACTGAA	1	1
CTATTCTTCGATGTC	CTATTCTTCGATGTC	2	1
TGCACTATTTCTTAA	TGCACTATTTCTTAA	1	1
CATCTAATTAAAAGG	CATCTAATTAAAAGG	1	1
TTCTGATATCAGTTC	TTCTGATATCAGTTC	1	1
AATATTAGTATTATG	AATATTAGTATTATG	1	1
GCTAATTCGTATTGA	GCTAATTCGTATTGA	1	1
GGTTTGTCATGCAAT	GGTTTGTCATGCAAT	1	1
ATCACTTCCTCTTTT	ATCACTTCCTCTTTT	1	1
TGCATGGGGTTTAAA	TGCATGGGGTTTAAA	2	1
TTTGTCGCCTGAGGG	TTTGTCGCCTGAGGG	1	1
ATTCGTGTCAAATTA	ATTCGTGTCAAATTA	1	1
GTTGGATCAAATAAC	GTTGGATCAAATAAC	1	1
TTCAACATGTACTCT	TTCAACATGTACTCT	1	1
TATAAACTGCCGTTT	TATAAACTGCCGTTT	1	1
ATTTATCTCTGGGCG	ATTTATCTCTGGGCG	1	1
GGCATTGCGACGGGT	GGCATTGCGACGGGT	1	1
TGTTACTCTTGCGTC	TGTTACTCTTGCGTC	1	1
CTCATATGCTTTGAT	CTCATATGCTTTGAT	1	1
GGTGCGGTCAATGTT	GGTGCGGTCAATGTT	1	1
TTATTCCTAAATTTG	TTATTCCTAAATTTG	1	1
ATGGATGGAGGGTTA	ATGGATGGAGGGTTA	2	1
AAGCATATTTCTGCT	AAGCATATTTCTGCT	2	1
AATCGACTTTGTGGA	AATCGACTTTGTGGA	1	1
TTATGTTCCCTTTCT	TTATGTTCCCTTTCT	1	1
ATGAGACTCTCATAT	ATGAGACTCTCATAT	1	1
TGTCTCGACTATTAG	TGTCTCGACTATTAG	1	1
GCATTTTACTAAAGT	GCATTTTACTAAAGT	1	1
TTGTATCTCCTAATA	TTGTATCTCCTAATA	1	1
TTTGGGCTCGTATAC	TTTGGGCTCGTATAC	1	1
TTCCGTTAACAAATA	TTCCGTTAACAAATA	1	1
CTCATGTCTAAGCTA	CTCATGTCTAAGCTA	1	1
ACTGGCCGTTTTATC	ACTGGCCGTTTTATC	1	1
AACTATTGGTTACGT	AACTATTGGTTACGT	1	1
GGGACGGACGGCAGA	GGGACGGACGGCAGA	2	1
GTTCGTATCTAGCGG	GTTCGTATCTAGCGG	1	1
AAACTACGCTAGGAT	AAACTACGCTAGGAT	1	1
TAATGTGACTACAAC	TAATGTGACTACAAC	1	1
TTACGATCATCGACA	TTACGATCATCGACA	1	1
TTCGCATCTTTCAAC	TTCGCATCTTTCAAC	1	1
CAACTATAGCCTTAT	CAACTATAGCCTTAT	1	1
AATGCAAGTAAGTCT	AATGCAAGTAAGTCT	1	1
TTAAATAGGATTTCA	TTAAATAGGATTTCA	1	1
GGTTTGACAGTCGGT	GGTTTGACAGTCGGT	2	1
GGAGGGGGCGCGGAA	GGAGGGGGCGCGGAA	1	1
AACCTTACGTAAGCT	AACCTTACGTAAGCT	1	1
TGGGTTCTTGCTCTT	TGGGTTCTTGCTCTT	1	1
GTAACTTACCTAATT	GTAACTTACCTAATT	1	1
GGTTGGTGCTGAGAA	GGTTGGTGCTGAGAA	1	1
CTGAAGGGTAGATCT	CTGAAGGGTAGATCT	1	1
AGCTGCTGATCTAAG	AGCTGCTGATCTAAG	1	1
AAGAACTATGTGTTG	AAGAACTATGTGTTG	1	1
GTTTGATTAACTTAT	GTTTGATTAACTTAT	1	1
TATGGGGCTGGTTGG	TATGGGGCTGGTTGG	1	1
ATATTTCCATCACGT	ATATTTCCATCACGT	1	1
CCTGCGGACTATACG	CCTGCGGACTATACG	1	1
AACGCAACAATACTT	AACGCAACAATACTT	1	1
CCTGGTCGCGCACAT	CCTGGTCGCGCACAT	1	1
TACATCGCGTCGTTA	TACATCGCGTCGTTA	1	1
GAAAAACTCACCTTT	GAAAAACTCACCTTT	1	1
TTCTTTTGCTTAAAA	TTCTTTTGCTTAAAA	1	1
AGTGAGTTGTGGTCT	AGTGAGTTGTGGTCT	2	1
TAAGGTACTTTTCGA	TAAGGTACTTTTCGA	2	1
GCGATACATCAGTTA	GCGATACATCAGTTA	1	1
CACCCTTGGAATCTG	CACCCTTGGAATCTG	1	1
AACGGTTATTCAAGT	AACGGTTATTCAAGT	1	1
ATGTGTCCTTAAGAT	ATGTGTCCTTAAGAT	1	1
ATATTTTTGGTCTCT	ATATTTTTGGTCTCT	1	1
GGGTTGGAATACTTT	GGGTTGGAATACTTT	1	1
GCAAGGAGCTAAGCG	GCAAGGAGCTAAGCG	1	1
GGCATTCGTCACAAT	GGCATTCGTCACAAT	1	1
TCCTTCACATTTAAT	TCCTTCACATTTAAT	1	1
TTGCTTCATTTCGTA	TTGCTTCATTTCGTA	1	1
CTGATCATCTATGCT	CTGATCATCTATGCT	1	1
CTCCACACGGTGTGA	CTCCACACGGTGTGA	1	1
CGGTTTAAGTAACAT	CGGTTTAAGTAACAT	1	1
AGAATATTGTCGTAT	AGAATATTGTCGTAT	1	1
GTTCTGTAAAATCCA	GTTCTGTAAAATCCA	2	1
GCTGTACCGTCTAGA	GCTGTACCGTCTAGA	1	1
TGGGGTTGCGTCAGT	TGGGGTTGCGTCAGT	1	1
AATAAGTGATTCCAG	AATAAGTGATTCCAG	1	1
TCTAATTGTCCTTCT	TCTAATTGTCCTTCT	1	1
TACGTCTGTTAACGT	TACGTCTGTTAACGT	1	1
TAAACTGTAGATTCT	TAAACTGTAGATTCT	1	1
TAATTGTTCGCCCAC	TAATTGTTCGCCCAC	1	1
ATCGTGCAATTGGCG	ATCGTGCAATTGGCG	1	1
GTTGGAATTTCGGGA	GTTGGAATTTCGGGA	1	1
GCATGGAGGTAAGTA	GCATGGAGGTAAGTA	1	1
AGGACTTCGATCCGT	AGGACTTCGATCCGT	1	1
TTTTGGCATGGTCCT	TTTTGGCATGGTCCT	1	1
GCTGTGGGGGGACGC	GCTGTGGGGGGACGC	1	1
CTACTCTGGATGTAA	CTACTCTGGATGTAA	1	1
TTGTAAATCATATGA	TTGTAAATCATATGA	1	1
ATCCTTCAGCTTGAG	ATCCTTCAGCTTGAG	1	1
ATAAGCTACATACAT	ATAAGCTACATACAT	1	1
TTCCAGGAATGATTG	TTCCAGGAATGATTG	1	1
TACATCTTCAGGGTA	TACATCTTCAGGGTA	1	1
ACATGGTTGGCAGGG	ACATGGTTGGCAGGG	1	1
TACTGCTAAAGGATT	TACTGCTAAAGGATT	1	1
AATCGGTTAAGCAAA	AATCGGTTAAGCAAA	1	1
CTCTATGGGGTGAAG	CTCTATGGGGTGAAG	1	1
GCAGGCAATGGAGCG	GCAGGCAATGGAGCG	2	1
GTTTCGGTGGCGATG	GTTTCGGTGGCGATG	1	1
TTAAGCTGTGTTTTA	TTAAGCTGTGTTTTA	1	1
GTGCAGATCTTTATA	GTGCAGATCTTTATA	1	1
TAACTCTCTGCGTTA	TAACTCTCTGCGTTA	1	1
GGATGTAATAGAGAT	GGATGTAATAGAGAT	1	1
CTATTATCTCCTCAA	CTATTATCTCCTCAA	1	1
ACAATGATTTATCCA	ACAATGATTTATCCA	1	1
TAAATGTGCCCTTTA	TAAATGTGCCCTTTA	1	1
CAACACGGCATCAAT	CAACACGGCATCAAT	1	1
TATTGACTCGTAATT	TATTGACTCGTAATT	1	1
TATTAAGCTTATGTG	TATTAAGCTTATGTG	1	1
CTACTCGTGTTAATA	CTACTCGTGTTAATA	1	1
ATTAATCGCTCATTT	ATTAATCGCTCATTT	1	1
ATTTAAAACTGAAAT	ATTTAAAACTGAAAT	1	1
GGGCGAACAGTGGGG	GGGCGAACAGTGGGG	1	1
CAGGCAACTTCCATG	CAGGCAACTTCCATG	1	1
TCAACGCAGTCTTTA	TCAACGCAGTCTTTA	1	1
AGCACACGTCATTGG	AGCACACGTCATTGG	1	1
CACCCTGTACAGGTT	CACCCTGTACAGGTT	2	1
TTCAATCCTAATAGT	TTCAATCCTAATAGT	1	1
CGGCTTTTATCCTCG	CGGCTTTTATCCTCG	2	1
TCATATATTGAATTG	TCATATATTGAATTG	1	1
AGTTATCTCAGGTCG	AGTTATCTCAGGTCG	1	1
ATATGGAAAAAGTTC	ATATGGAAAAAGTTC	1	1
ATATTGAATAAAATA	ATATTGAATAAAATA	1	1
TCAGACTACCTAGAA	TCAGACTACCTAGAA	1	1
TTACATGGAATACGT	TTACATGGAATACGT	1	1
TTACTTATATAATCA	TTACTTATATAATCA	1	1
AGAAGTTGCAGACAA	AGAAGTTGCAGACAA	1	1
GGTATCGTCTTAGTG	GGTATCGTCTTAGTG	1	1
AATAGCCTAGAAAAT	AATAGCCTAGAAAAT	1	1
TATGTTTAAATTTAA	TATGTTTAAATTTAA	1	1
TCTATATCGCTGGAC	TCTATATCGCTGGAC	3	1
CGCAGCGTAAACACA	CGCAGCGTAAACACA	1	1
GGGGTCTCTGCTGTT	GGGGTCTCTGCTGTT	1	1
TGTAATCTACTGCGC	TGTAATCTACTGCGC	1	1
GCAGTTAGCCGTTCA	GCAGTTAGCCGTTCA	1	1
GGTATATCTTAGTAT	GGTATATCTTAGTAT	1	1
CTATACTACTTAAAT	CTATACTACTTAAAT	1	1
TGCCATTCAGAGGGA	TGCCATTCAGAGGGA	1	1
AGTCTCACCTTTTGT	AGTCTCACCTTTTGT	1	1
GTACACAAATATCGA	GTACACAAATATCGA	1	1
AAAGGTTGGTCTGGG	AAAGGTTGGTCTGGG	1	1
TGGCATGGCTTTGAC	TGGCATGGCTTTGAC	1	1
GTATTGTCCACTTTT	GTATTGTCCACTTTT	1	1
CATGAAGCAACTATC	CATGAAGCAACTATC	1	1
CGGGGGGGGGCGCCG	CGGGGGGGGGCGCCG	1	1
ATCTGCTTGTAACTT	ATCTGCTTGTAACTT	1	1
GCGGATTAGCGCTTC	GCGGATTAGCGCTTC	1	1
GGAAACGTTTTAATT	GGAAACGTTTTAATT	1	1
ATACCCACGTTCTAT	ATACCCACGTTCTAT	1	1
TCTGGTTTGAGGCAC	TCTGGTTTGAGGCAC	1	1
AAGAACTCTTCAAAG	AAGAACTCTTCAAAG	1	1
AGCATTGATTTTTAT	AGCATTGATTTTTAT	1	1
CTGGGGTTTAATCTA	CTGGGGTTTAATCTA	1	1
TAACGCATAGATAGG	TAACGCATAGATAGG	1	1
GTGGGGAGCAGTGGG	GTGGGGAGCAGTGGG	1	1
GTTAAAATTTACAAA	GTTAAAATTTACAAA	1	1
GTTCACTATTCTACG	GTTCACTATTCTACG	1	1
CGAGGCGAATAGCTG	CGAGGCGAATAGCTG	1	1
CGAAAACATTCTAGG	CGAAAACATTCTAGG	1	1
ATTATTGTTCTATTA	ATTATTGTTCTATTA	1	1
CACTTGTCTGTAGGT	CACTTGTCTGTAGGT	1	1
ACTACTGATTTATCA	ACTACTGATTTATCA	2	1
TTTTAACGCATCATT	TTTTAACGCATCATT	2	1
ACCTTCGGCGTTGTA	ACCTTCGGCGTTGTA	1	1
GGACCGTGCCATACG	GGACCGTGCCATACG	1	1
GAGTAACGTTGGTCG	GAGTAACGTTGGTCG	3	1
TGGCGTAGTGGCTGG	TGGCGTAGTGGCTGG	1	1
GCGGTGTGGATATCA	GCGGTGTGGATATCA	1	1
ACTTTTACAAATTTC	ACTTTTACAAATTTC	1	1
GACGATTAGTTAATA	GACGATTAGTTAATA	1	1
ACATGGGTAAGCTGC	ACATGGGTAAGCTGC	1	1
AAAGTTCTGCAGCGT	AAAGTTCTGCAGCGT	1	1
TACATAGTTTTGTCA	TACATAGTTTTGTCA	1	1
AGCGCCACTCAACTT	AGCGCCACTCAACTT	1	1
ACTGTAGAATCGTGA	ACTGTAGAATCGTGA	1	1
TTTAAGCCCTAAGGG	TTTAAGCCCTAAGGG	1	1
CTTACTTAGGGGGGC	CTTACTTAGGGGGGC	1	1
TGCTAGTCGGGCCAT	TGCTAGTCGGGCCAT	1	1
TTGCCTGGTTTACAT	TTGCCTGGTTTACAT	1	1
GTTTCCTGATATGTT	GTTTCCTGATATGTT	1	1
ATTTGTTCTTTTCAT	ATTTGTTCTTTTCAT	1	1
TCTGGTACTCGGTGG	TCTGGTACTCGGTGG	1	1
CTTCGCATAGTGAAA	CTTCGCATAGTGAAA	1	1
TAGGGGAGGGGGATT	TAGGGGAGGGGGATT	1	1
GGAAATCAACACATA	GGAAATCAACACATA	1	1
GGGTGGGGGGGGGTT	GGGTGGGGGGGGGTT	1	1
CACACTTCTCTAAGT	CACACTTCTCTAAGT	1	1
ACAAAGATTCTTGGT	ACAAAGATTCTTGGT	1	1
GAACAGAAGGCAAGT	GAACAGAAGGCAAGT	1	1
TTCTAGTTAGCATTC	TTCTAGTTAGCATTC	1	1
TCATATGCCCAACCA	TCATATGCCCAACCA	1	1
GTTTATGAGAGCTAT	GTTTATGAGAGCTAT	1	1
GGACGCCACCTATTC	GGACGCCACCTATTC	1	1
CAGAATTGCCATTTG	CAGAATTGCCATTTG	1	1
TAGATTATATTTTTT	TAGATTATATTTTTT	1	1
GAATGTGTTATCGCT	GAATGTGTTATCGCT	1	1
TGATCTAATGTGTTA	TGATCTAATGTGTTA	1	1
GCAAGTCATAACTGT	GCAAGTCATAACTGT	1	1
ATATGTTGGTCTCGG	ATATGTTGGTCTCGG	1	1
GTGGCCTTTCCTATT	GTGGCCTTTCCTATT	1	1
CGAGGAAGTTTTTTA	CGAGGAAGTTTTTTA	1	1
TAGAGGGCGTTAAGA	TAGAGGGCGTTAAGA	1	1
TTGCTTTCATACTGC	TTGCTTTCATACTGC	1	1
TTCGTTACAATTGGT	TTCGTTACAATTGGT	1	1
GACTATAGTTCGTTA	GACTATAGTTCGTTA	1	1
TCGACTTATAATACA	TCGACTTATAATACA	2	1
CAAAGAAGGTTTAGC	CAAAGAAGGTTTAGC	1	1
ATACTTCTGACGCAT	ATACTTCTGACGCAT	1	1
ATAGTAATTTTATCA	ATAGTAATTTTATCA	1	1
CTATGCATTACGGCA	CTATGCATTACGGCA	1	1
GCGTATTTTCATGTC	GCGTATTTTCATGTC	1	1
GTCTGTTTGGCCTGT	GTCTGTTTGGCCTGT	1	1
TAATTAAATCGTTTA	TAATTAAATCGTTTA	1	1
TATTGTGCAAGCAAT	TATTGTGCAAGCAAT	1	1
TTAGCAATACTACTT	TTAGCAATACTACTT	1	1
GATTCTTTATTATTA	GATTCTTTATTATTA	1	1
ACTGTTAGCAACTAA	ACTGTTAGCAACTAA	1	1
TGATGGTCATGTGGG	TGATGGTCATGTGGG	2	1
TTCTATGCCATTGGT	TTCTATGCCATTGGT	1	1
TAAATGCTAAATCTA	TAAATGCTAAATCTA	1	1
GACTACGTGTGCGAT	GACTACGTGTGCGAT	1	1
GCACCTTCTTATGGT	GCACCTTCTTATGGT	1	1
GACATCAACAAAAGT	GACATCAACAAAAGT	1	1
TCACGCTTTCTTTAT	TCACGCTTTCTTTAT	1	1
AGTTTCAACCAGTAG	AGTTTCAACCAGTAG	1	1
TCTGGGGCAGTGTGA	TCTGGGGCAGTGTGA	1	1
CTTGCTATGCTTGCA	CTTGCTATGCTTGCA	1	1
TAGCAGTCTTAGATC	TAGCAGTCTTAGATC	1	1
ACCTTCGGCTCCAAA	ACCTTCGGCTCCAAA	1	1
TATTTGTACCCCATG	TATTTGTACCCCATG	1	1
CTGTTCGGTGGTCTT	CTGTTCGGTGGTCTT	1	1
ACATAGATTGCGGGG	ACATAGATTGCGGGG	1	1
CTGGCGCAGGGGCGG	CTGGCGCAGGGGCGG	1	1
ATTTAGGGATAATTT	ATTTAGGGATAATTT	1	1
GCTGTATAAAAAAAA	GCTGTATAAAAAAAA	1	1
GATATTTATCACCAT	GATATTTATCACCAT	1	1
TATCTTTGAGAATAT	TATCTTTGAGAATAT	1	1
TGCGAAAGCTTGTTT	TGCGAAAGCTTGTTT	1	1
GTGTAGCAACGCATA	GTGTAGCAACGCATA	1	1
CGTACACTACTTGTA	CGTACACTACTTGTA	1	1
ATCTTTAGGCGTGCG	ATCTTTAGGCGTGCG	1	1
GAGCTGGTTTTAAGA	GAGCTGGTTTTAAGA	1	1
TTCACCATAGTATTT	TTCACCATAGTATTT	1	1
AACAAATCTTAGTAC	AACAAATCTTAGTAC	1	1
ACGGGGGGGAAGCGG	ACGGGGGGGAAGCGG	1	1
CACATTCCAGAATTG	CACATTCCAGAATTG	1	1
GTGGGGAGGGGGCGG	GTGGGGAGGGGGCGG	1	1
GGGCCTGTTGTGTGA	GGGCCTGTTGTGTGA	1	1
GTATGTTCGCCTTTT	GTATGTTCGCCTTTT	1	1
GTATTTACGCCTTGT	GTATTTACGCCTTGT	1	1
TATTCTGCGCCGCCT	TATTCTGCGCCGCCT	1	1
AGTATCGTTAATAAA	AGTATCGTTAATAAA	1	1
ATCGGATCGTTGTCC	ATCGGATCGTTGTCC	1	1
CCGGATGCATTTGCA	CCGGATGCATTTGCA	1	1
GCATTGTGTTAATCA	GCATTGTGTTAATCA	1	1
TCATGGTGGGGAAGG	TCATGGTGGGGAAGG	1	1
TGAATGCAGGCGTGA	TGAATGCAGGCGTGA	1	1
GGTAGTTGAGAAGTT	GGTAGTTGAGAAGTT	1	1
TAGAGTAATTATTTG	TAGAGTAATTATTTG	1	1
AGATTAGGTGACTAA	AGATTAGGTGACTAA	1	1
CCATGAACGTTAATT	CCATGAACGTTAATT	1	1
TCTTGGAATCCTATC	TCTTGGAATCCTATC	1	1
TTTCATGCGCCTTTG	TTTCATGCGCCTTTG	1	1
CTATAGGAGGGTGGT	CTATAGGAGGGTGGT	1	1
GTCGAGAGATAGATT	GTCGAGAGATAGATT	1	1
AGCGTTGGGGATGAA	AGCGTTGGGGATGAA	1	1
GTTCGATAAACGATA	GTTCGATAAACGATA	1	1
CTGGAGGGTGGAAGC	CTGGAGGGTGGAAGC	1	1
ACAAGGCAGTAGAAT	ACAAGGCAGTAGAAT	1	1
TTAACATGGATCGGA	TTAACATGGATCGGA	1	1
AGGGGTCAAGCTGCG	AGGGGTCAAGCTGCG	1	1
TAGTTTAGTAAAACT	TAGTTTAGTAAAACT	1	1
GTTTGCGAAGTTTGC	GTTTGCGAAGTTTGC	1	1
TGGCGAGGGGGGAAC	TGGCGAGGGGGGAAC	1	1
TGAAGTACTCGGATA	TGAAGTACTCGGATA	1	1
CCTAATCACGTATGA	CCTAATCACGTATGA	1	1
CATCCTCATCGTATC	CATCCTCATCGTATC	1	1
GTCCTCACAGGATCG	GTCCTCACAGGATCG	1	1
ATTCCCACGTCTCTT	ATTCCCACGTCTCTT	1	1
ATTCGTTTCGCTCTT	ATTCGTTTCGCTCTT	1	1
CGCAATGAAATTTGT	CGCAATGAAATTTGT	1	1
TCAACGTTAGGCCTT	TCAACGTTAGGCCTT	1	1
TTTACTTGGGGCATG	TTTACTTGGGGCATG	1	1
AGTGAGTGCGTGAGG	AGTGAGTGCGTGAGG	1	1
GTGGGGTGGCGGGGG	GTGGGGTGGCGGGGG	1	1
ATATATTATTTCCCT	ATATATTATTTCCCT	1	1
ATCACACGGATTAAA	ATCACACGGATTAAA	1	1
AGCGATGTATTATAC	AGCGATGTATTATAC	1	1
GCTGGTGATGTTTAG	GCTGGTGATGTTTAG	1	1
TAGGAGTAGACTTGG	TAGGAGTAGACTTGG	1	1
TTTTTCTTCGATGCT	TTTTTCTTCGATGCT	1	1
TCAACTATAATGGCG	TCAACTATAATGGCG	1	1
ATCGCAACCGCTGGA	ATCGCAACCGCTGGA	1	1
CTTAAAATCATTTTG	CTTAAAATCATTTTG	1	1
AAAGACTGTTGATCG	AAAGACTGTTGATCG	1	1
GTTCGGGTCGGTGGT	GTTCGGGTCGGTGGT	2	1
CTCTAGCATGTTTCA	CTCTAGCATGTTTCA	1	1
TTGGATGATTTGGGA	TTGGATGATTTGGGA	1	1
GCAAATTTCCGGTGA	GCAAATTTCCGGTGA	1	1
AGAGGTATGGAACAA	AGAGGTATGGAACAA	1	1
TTCGGATTTAAAGGG	TTCGGATTTAAAGGG	1	1
TAGTTATTTGCTTGT	TAGTTATTTGCTTGT	1	1
GTACAAGTTCCGATT	GTACAAGTTCCGATT	1	1
ATTAGGGACTACGAT	ATTAGGGACTACGAT	1	1
CATTCACTAATTACC	CATTCACTAATTACC	1	1
TGTACGTCCCTTCTT	TGTACGTCCCTTCTT	1	1
GGGCTGGTTGTACTG	GGGCTGGTTGTACTG	1	1
GTGAAGTCGCGAGTG	GTGAAGTCGCGAGTG	1	1
GAATTTAATATCTTC	GAATTTAATATCTTC	1	1
TAATGATCGAGCGTA	TAATGATCGAGCGTA	1	1
GCCAGATGTGTAAAT	GCCAGATGTGTAAAT	1	1
TTATTTACTGTTGAA	TTATTTACTGTTGAA	1	1
ATACGAAGGGTACTA	ATACGAAGGGTACTA	1	1
ACTATAACAAAATTA	ACTATAACAAAATTA	1	1
CACCAAACCATTGAC	CACCAAACCATTGAC	1	1
TCTTGTGGACTGTGA	TCTTGTGGACTGTGA	1	1
TGATATTTCACTTAT	TGATATTTCACTTAT	1	1
AGTTCATTGCATTAA	AGTTCATTGCATTAA	1	1
TGAACGGTTCTCATA	TGAACGGTTCTCATA	1	1
GTTCCTTTAAACATT	GTTCCTTTAAACATT	2	1
TGTTTTTAGTCGCTT	TGTTTTTAGTCGCTT	1	1
GCGAATTTCCTACCG	GCGAATTTCCTACCG	1	1
TCTCTGAATTTCACA	TCTCTGAATTTCACA	1	1
TCCTATCCTTATACA	TCCTATCCTTATACA	1	1
TAAGCACCGTTTGTA	TAAGCACCGTTTGTA	1	1
AGGTTACGTTTTTTA	AGGTTACGTTTTTTA	1	1
TCAATTACCATTTTT	TCAATTACCATTTTT	1	1
TGGGACCTCATGATT	TGGGACCTCATGATT	1	1
TATATGGGTGATACG	TATATGGGTGATACG	1	1
ACGATATGGAGTGTT	ACGATATGGAGTGTT	1	1
ATTTGTTGTCGGGAT	ATTTGTTGTCGGGAT	1	1
CATCTAGGCATCTAC	CATCTAGGCATCTAC	1	1
CGCGCGGCGGAACGG	CGCGCGGCGGAACGG	1	1
TTGCAAAAATCTAGT	TTGCAAAAATCTAGT	1	1
GAACAATTATCACCA	GAACAATTATCACCA	1	1
TCGCAGCTAAACGAA	TCGCAGCTAAACGAA	1	1
AGTGATGCGCGGTTT	AGTGATGCGCGGTTT	1	1
ACGAATCTAGAGTAT	ACGAATCTAGAGTAT	1	1
GTGGAGAGTGATGTC	GTGGAGAGTGATGTC	1	1
TACGCCAACTATTAT	TACGCCAACTATTAT	1	1
AAACATTCGACACAA	AAACATTCGACACAA	1	1
GGGATGTAGCGATTC	GGGATGTAGCGATTC	1	1
GTTTGGGTATCTTGG	GTTTGGGTATCTTGG	1	1
CGGGGCGCCCATCAT	CGGGGCGCCCATCAT	1	1
TTATTTCCAACGCTT	TTATTTCCAACGCTT	1	1
GCGCCGTCGGACCCG	GCGCCGTCGGACCCG	1	1
CGTACTTTTTTTACT	CGTACTTTTTTTACT	1	1
TTAAAATATGACAGT	TTAAAATATGACAGT	1	1
AGAAAGCAGTACGGT	AGAAAGCAGTACGGT	1	1
TCGGTACAGATTAAC	TCGGTACAGATTAAC	1	1
GGCAACGACTTTGTA	GGCAACGACTTTGTA	1	1
GTTTGGCGAAGGCTG	GTTTGGCGAAGGCTG	1	1
TACGTCTTTTATTAA	TACGTCTTTTATTAA	1	1
CCATTGAGGTACGTT	CCATTGAGGTACGTT	1	1
CCTTGTGTTGCGTTG	CCTTGTGTTGCGTTG	1	1
GGCGAAGGGGGGCGG	GGCGAAGGGGGGCGG	1	1
CCGATGGCGTCATTG	CCGATGGCGTCATTG	1	1
GCACCTGGTGCGGTC	GCACCTGGTGCGGTC	1	1
GCAACTTAAGTTGTA	GCAACTTAAGTTGTA	1	1
GTTGACTACTTCCGC	GTTGACTACTTCCGC	1	1
AATTGCATTAATCAC	AATTGCATTAATCAC	1	1
AGGGGGGGCGATGAC	AGGGGGGGCGATGAC	1	1
TGAAAATATGACAGT	TGAAAATATGACAGT	1	1
CCTTACACCTGAAGT	CCTTACACCTGAAGT	1	1
ACGGCGGAGAGGGGC	ACGGCGGAGAGGGGC	1	1
CGGGGGCACGGACGC	CGGGGGCACGGACGC	1	1
CTGTGAACAATTTGC	CTGTGAACAATTTGC	1	1
ACAAGGTTGTTATAT	ACAAGGTTGTTATAT	1	1
TGAATCATTTTGTGT	TGAATCATTTTGTGT	1	1
TGGGTATTTTCGTGT	TGGGTATTTTCGTGT	1	1
GATGCTATTCTTTAA	GATGCTATTCTTTAA	1	1
GATTCGTCCTTAATA	GATTCGTCCTTAATA	1	1
TCTGCCGTCCCATTC	TCTGCCGTCCCATTC	2	1
AATCCTTAGAATTTA	AATCCTTAGAATTTA	1	1
TTATGCCGTGGTCTA	TTATGCCGTGGTCTA	1	1
GTAGCGGGGTAGGAC	GTAGCGGGGTAGGAC	1	1
AGCATGAGCGTGCGA	AGCATGAGCGTGCGA	1	1
CCATTTGTTTTACAT	CCATTTGTTTTACAT	1	1
GAGATTCCAACGGGG	GAGATTCCAACGGGG	1	1
CGGGCGATTGCATGT	CGGGCGATTGCATGT	1	1
ACTAGTGTATTGCAA	ACTAGTGTATTGCAA	1	1
ACACACGCCCTTGTA	ACACACGCCCTTGTA	1	1
ATACTGTCTCATCAC	ATACTGTCTCATCAC	1	1
TTTGTAACGGTGGGT	TTTGTAACGGTGGGT	1	1
CCCTTAACAGAGGTT	CCCTTAACAGAGGTT	1	1
ATACAAATTTACGGT	ATACAAATTTACGGT	1	1
ATTGTTCCTGATATA	ATTGTTCCTGATATA	1	1
TATGTTTATGGTTAC	TATGTTTATGGTTAC	1	1
CTTACAAAGTTGATT	CTTACAAAGTTGATT	1	1
TCTTCTGTGCTATTC	TCTTCTGTGCTATTC	1	1
AACGGGTCTAATATA	AACGGGTCTAATATA	1	1
GATACATCCCTGATC	GATACATCCCTGATC	1	1
AAATCCTGCATCGAA	AAATCCTGCATCGAA	1	1
TGCGCGTGACTCATG	TGCGCGTGACTCATG	1	1
TATCCTCAATTCTAT	TATCCTCAATTCTAT	1	1
TATGAGGATTATCAA	TATGAGGATTATCAA	1	1
TTTGGATATGGTCGT	TTTGGATATGGTCGT	1	1
ATATTCTTTAAGCAT	ATATTCTTTAAGCAT	1	1
AACATTGCATCCACG	AACATTGCATCCACG	1	1
GCTGGCAAATCTCGT	GCTGGCAAATCTCGT	1	1
TCACAATGATGTCTT	TCACAATGATGTCTT	1	1
GGACTTTTAAAGCAG	GGACTTTTAAAGCAG	1	1
TTAATGAAATAGGTT	TTAATGAAATAGGTT	1	1
CGTGTATCATGTTGT	CGTGTATCATGTTGT	1	1
CTAGCTTAGCACCGT	CTAGCTTAGCACCGT	1	1
GTCTTATGTGAGATT	GTCTTATGTGAGATT	1	1
GGTTTCAACCAGATA	GGTTTCAACCAGATA	1	1
TACCCGTGGGTAAGG	TACCCGTGGGTAAGG	1	1
AATCGCACATCTAAT	AATCGCACATCTAAT	1	1
GTTCGCAGATACGCA	GTTCGCAGATACGCA	1	1
CCGGCCCGGATGTGA	CCGGCCCGGATGTGA	1	1
CCAGAGTTAGTTACT	CCAGAGTTAGTTACT	1	1
GCTTCGCAAGCTGGG	GCTTCGCAAGCTGGG	1	1
GTTCAGGGGAGGGTA	GTTCAGGGGAGGGTA	1	1
TACAGCTAAATACTA	TACAGCTAAATACTA	2	1
TGTTCAGTTGTAATC	TGTTCAGTTGTAATC	2	1
