ID	BARCODE	SEQCOUNT	CLUSTERS
CCCTTTTGCATGGGT	CCCTTTTGCATGGGT	1	1
ACTGCCAGTTCAAAT	ACTGCCAGTTCAAAT	1	1
TCGAAAATTCCCTTA	TCGAAAATTCCCTTA	1	1
TTCCCATTAAACTTT	TTCCCATTAAACTTT	1	1
CCCTATTTGTCATTA	CCCTATTTGTCATTA	1	1
TGTTCATTGTACCGG	TGTTCATTGTACCGG	1	1
TACTTCAATATGGAA	TACTTCAATATGGAA	1	1
TCCTGCAGCAGTCGT	TCCTGCAGCAGTCGT	1	1
GTCAATGGATGAGTA	GTCAATGGATGAGTA	3	1
GTTCGTTTGCTGTCG	GTTCGTTTGCTGTCG	2	1
ATAAGCTTAGAAGCA	ATAAGCTTAGAAGCA	3	1
GAGCGGTCTTGGTTG	GAGCGGTCTTGGTTG	1	1
CAGTGTAGTCATTAA	CAGTGTAGTCATTAA	1	1
CCCATACCGCATGGG	CCCATACCGCATGGG	1	1
AAGCGCCCTCTGTGA	AAGCGCCCTCTGTGA	1	1
GTCAATGATACTACG	GTCAATGATACTACG	1	1
TTCTTTTTCACGGCT	TTCTTTTTCACGGCT	1	1
AGTATTTAGCAGTGT	AGTATTTAGCAGTGT	3	1
GTGGAACATCCTATT	GTGGAACATCCTATT	1	1
AGATTTCTCTAGACT	AGATTTCTCTAGACT	1	1
CTCCCGTGTTATTAT	CTCCCGTGTTATTAT	1	1
GGTCGAGAGTCACGG	GGTCGAGAGTCACGG	1	1
AAGCCTGGAGATTCG	AAGCCTGGAGATTCG	2	1
GGGATACGCTTGTCG	GGGATACGCTTGTCG	1	1
GAATGAACTTACCGT	GAATGAACTTACCGT	2	1
TTCAAGAAATAGATT	TTCAAGAAATAGATT	1	1
TTCCGAAGGTAGATC	TTCCGAAGGTAGATC	3	1
TATCTTATACGTTCT	TATCTTATACGTTCT	1	1
AGATTTGCTCGTAAT	AGATTTGCTCGTAAT	3	1
GGAACCCGTTACTTC	GGAACCCGTTACTTC	1	1
ATGGAAGGTTCGGTC	ATGGAAGGTTCGGTC	1	1
TGACTTACAATGCTG	TGACTTACAATGCTG	2	1
GCGTATGGAGGAGTC	GCGTATGGAGGAGTC	2	1
GGCATGTTTACTACT	GGCATGTTTACTACT	1	1
GCAAAAGCGGGCAGT	GCAAAAGCGGGCAGT	2	1
CGTACATAAGGAGTA	CGTACATAAGGAGTA	2	1
ACCGGAAGGGTGAGT	ACCGGAAGGGTGAGT	1	1
GGTGGCGGTGGGGGG	GGTGGCGGTGGGGGG	1	1
TGCGCGGTAGGCAGT	TGCGCGGTAGGCAGT	1	1
TTCATTGGTGCTCAT	TTCATTGGTGCTCAT	3	1
GTGGAGGTGCCAGTT	GTGGAGGTGCCAGTT	1	1
AAGCGATAGTAAGGA	AAGCGATAGTAAGGA	1	1
TGCGCTGGGGCTATA	TGCGCTGGGGCTATA	3	1
TGTGCGGTATGCCTT	TGTGCGGTATGCCTT	1	1
TGACTTTCCTTCTCT	TGACTTTCCTTCTCT	1	1
ACATAGTGTGCTCTG	ACATAGTGTGCTCTG	4	1
CTGTTCGCGGGGCTG	CTGTTCGCGGGGCTG	1	1
ACACACTACGACTTG	ACACACTACGACTTG	5	1
TCGGTATTACTTCCT	TCGGTATTACTTCCT	1	1
CAATGCAATTTTATA	CAATGCAATTTTATA	1	1
GATCAATCTATATTT	GATCAATCTATATTT	1	1
CAAGAGATCATATTT	CAAGAGATCATATTT	1	1
AAAAGATAGCCGCTA	AAAAGATAGCCGCTA	3	1
TCTTAATATCATTTT	TCTTAATATCATTTT	1	1
CTGTAAGCTACATGC	CTGTAAGCTACATGC	1	1
GCTAATGCGGGGGTG	GCTAATGCGGGGGTG	1	1
GGGGGAGGCCTACGG	GGGGGAGGCCTACGG	1	1
TGTGTGAACCTCGGC	TGTGTGAACCTCGGC	3	1
CTGGAACTGATATAT	CTGGAACTGATATAT	1	1
TATAAATTTAGGAGT	TATAAATTTAGGAGT	2	1
AATCTTCTCTGAGGT	AATCTTCTCTGAGGT	4	1
CCGACGCGCCGTGGT	CCGACGCGCCGTGGT	2	1
TACGTTCGATGGGAT	TACGTTCGATGGGAT	1	1
AATGAGTAGATTTTC	AATGAGTAGATTTTC	3	1
GATCATTACTACGAT	GATCATTACTACGAT	1	1
TTCTGTGATAAATGA	TTCTGTGATAAATGA	1	1
GCGGGAGCAGTATTA	GCGGGAGCAGTATTA	1	1
GTTCATGTTTTATTT	GTTCATGTTTTATTT	1	1
ACTTACCACTAAACT	ACTTACCACTAAACT	4	1
ATACTGTTCAAAGAA	ATACTGTTCAAAGAA	4	1
AATAATTATCTCATT	AATAATTATCTCATT	1	1
AGCGCGGGGCGCGGG	AGCGCGGGGCGCGGG	3	1
TTTCCCGTACGCCGC	TTTCCCGTACGCCGC	1	1
ATTATGAATTCTCCC	ATTATGAATTCTCCC	1	1
GGTCTCCCTGGGTAT	GGTCTCCCTGGGTAT	2	1
GACGAGCACTTAGGA	GACGAGCACTTAGGA	1	1
TCACTGCCGTGTAAC	TCACTGCCGTGTAAC	11	1
CAACCGGAAATAATA	CAACCGGAAATAATA	1	1
TTCAAACTCATAAAC	TTCAAACTCATAAAC	1	1
TCGCTTATGCGTCTC	TCGCTTATGCGTCTC	2	1
GGTTTTGGGAAATGA	GGTTTTGGGAAATGA	1	1
TTATACTTCCGCTCG	TTATACTTCCGCTCG	1	1
TGAAGTTTTGCTCTG	TGAAGTTTTGCTCTG	4	1
TGTCTACCTCCACTT	TGTCTACCTCCACTT	3	1
ACCCGCGTGATTCTA	ACCCGCGTGATTCTA	3	1
CAAATCATTCTTTTA	CAAATCATTCTTTTA	2	1
GGTACTTGTTTAAGT	GGTACTTGTTTAAGT	1	1
TCTTGACCGTCTTTT	TCTTGACCGTCTTTT	1	1
AGGAAGCCGGCCCCG	AGGAAGCCGGCCCCG	2	1
CGCTTATTTTCGCTA	CGCTTATTTTCGCTA	1	1
GCTTAAACTCCTTTC	GCTTAAACTCCTTTC	3	1
ATTTTATTGTACTCA	ATTTTATTGTACTCA	3	1
AAATTTAAGGAGTTA	AAATTTAAGGAGTTA	1	1
TTGTTATGCCCGGTG	TTGTTATGCCCGGTG	1	1
CAATCTTACACTACG	CAATCTTACACTACG	1	1
ATGTTCATTGAGCGA	ATGTTCATTGAGCGA	1	1
CTTTGTAAGATACTC	CTTTGTAAGATACTC	2	1
GATATTTCGATTTAA	GATATTTCGATTTAA	1	1
TGTCGGCGTGGGGTG	TGTCGGCGTGGGGTG	1	1
AATGCCTACAAGAGT	AATGCCTACAAGAGT	1	1
AGGGAGCATAGTGGA	AGGGAGCATAGTGGA	1	1
AAATGGACTCTGCCT	AAATGGACTCTGCCT	3	1
CTTAAATCTGAATCA	CTTAAATCTGAATCA	2	1
TTATCGGGCGATACT	TTATCGGGCGATACT	1	1
TATATAGGGTTGTGT	TATATAGGGTTGTGT	2	1
CTAACACAACTGTCA	CTAACACAACTGTCA	2	1
GAAGAGGAGTCGCAT	GAAGAGGAGTCGCAT	4	1
ATCAACCTGGGAGAC	ATCAACCTGGGAGAC	1	1
GTCTATGTCGTATAA	GTCTATGTCGTATAA	4	1
TCAAATCAATTACTA	TCAAATCAATTACTA	1	1
CATTGCAATTTATTT	CATTGCAATTTATTT	2	1
AGTCAGTTGTGATAG	AGTCAGTTGTGATAG	3	1
TTACTTCCCTTATTT	TTACTTCCCTTATTT	1	1
TTCAAAGCTTAACCA	TTCAAAGCTTAACCA	2	1
GGATTTAGAACTATT	GGATTTAGAACTATT	1	1
AAAGGTGTGTCAGGC	AAAGGTGTGTCAGGC	4	1
ACTTATCTTTAATTG	ACTTATCTTTAATTG	1	1
TCTCAAAGTGGAGTC	TCTCAAAGTGGAGTC	2	1
AAGGTGGGGGGGGTG	AAGGTGGGGGGGGTG	3	1
GTTTATCTATAACGT	GTTTATCTATAACGT	2	1
TCCGACTTTACTCAA	TCCGACTTTACTCAA	1	1
CGGAGGGGTCCTTGA	CGGAGGGGTCCTTGA	2	1
GATAAATACATTGTT	GATAAATACATTGTT	1	1
ACAGTAGATGATTCA	ACAGTAGATGATTCA	3	1
TCGTTCGGCCTTCGA	TCGTTCGGCCTTCGA	2	1
TCGTTCCGGATTATT	TCGTTCCGGATTATT	2	1
CGCTCACCTGTACAA	CGCTCACCTGTACAA	1	1
GGCGTCGGGGGAATT	GGCGTCGGGGGAATT	1	1
CAATTTGCCTACTTA	CAATTTGCCTACTTA	1	1
TCGACTCGAATATGG	TCGACTCGAATATGG	1	1
TGCGGTTGTGTGTAG	TGCGGTTGTGTGTAG	1	1
GTGTTAAGATCAAAC	GTGTTAAGATCAAAC	1	1
CGTCGTAAATTTTTG	CGTCGTAAATTTTTG	1	1
CGACTGCTCCGTCGA	CGACTGCTCCGTCGA	20	1
CTTGTACTTATAAAT	CTTGTACTTATAAAT	1	1
CCATATGGATAGACT	CCATATGGATAGACT	2	1
TTCTACTTATGTAAA	TTCTACTTATGTAAA	2	1
GTTGGGTGCCGCGGT	GTTGGGTGCCGCGGT	1	1
GTAGGATGTTTGCGT	GTAGGATGTTTGCGT	1	1
CAAACTTGTTGATGT	CAAACTTGTTGATGT	3	1
CTTGTCAATTATACG	CTTGTCAATTATACG	19	1
CACTATCATTTACAG	CACTATCATTTACAG	1	1
CCATTTTGGTCGTTG	CCATTTTGGTCGTTG	1	1
GCCTGTGTCAATATT	GCCTGTGTCAATATT	1	1
ATAATGCTAGTCTTG	ATAATGCTAGTCTTG	2	1
AAATGCCAGGTGTAA	AAATGCCAGGTGTAA	3	1
TGCTACATATATATG	TGCTACATATATATG	1	1
CAAGGTTAAATTTCT	CAAGGTTAAATTTCT	1	1
CGCTAGTATGCTGGT	CGCTAGTATGCTGGT	13	1
CTGGTATAGCTACTT	CTGGTATAGCTACTT	3	1
AATCTGCGTGTTGGT	AATCTGCGTGTTGGT	6	1
TAATTAGACGCTATA	TAATTAGACGCTATA	1	1
AATCTGCTTACTGGT	AATCTGCTTACTGGT	1	1
CCTTTAGGAAAGGCT	CCTTTAGGAAAGGCT	2	1
TTGTTTCCGTGCGAT	TTGTTTCCGTGCGAT	1	1
CTCAGCGGAGGGGCC	CTCAGCGGAGGGGCC	1	1
AGAACTTCGGACGAT	AGAACTTCGGACGAT	1	1
GCAGTACTGTTGGGG	GCAGTACTGTTGGGG	1	1
GAAAGGGAAGAAAAG	GAAAGGGAAGAAAAG	3	1
AGGTGCGGAGATGTA	AGGTGCGGAGATGTA	4	1
ACCGCTCTATGCATC	ACCGCTCTATGCATC	6	1
AATTTGACCCAACAC	AATTTGACCCAACAC	1	1
TTTGGCATTTAGTGT	TTTGGCATTTAGTGT	2	1
TAGCGACGTTTCGAC	TAGCGACGTTTCGAC	2	1
AGATTTAGTTATGAC	AGATTTAGTTATGAC	1	1
TTTAATAATAAGACA	TTTAATAATAAGACA	2	1
TCTTGCGCTACGGTC	TCTTGCGCTACGGTC	1	1
TATAGTCTTATGTAG	TATAGTCTTATGTAG	2	1
GGTTTAATCGTACGT	GGTTTAATCGTACGT	2	1
AAGTACTGATATCCT	AAGTACTGATATCCT	1	1
TCTGGAGTTTTTGTG	TCTGGAGTTTTTGTG	1	1
AGTTATGATTTACCA	AGTTATGATTTACCA	1	1
TGGTGCTGTCTCTCG	TGGTGCTGTCTCTCG	2	1
GTTTGCTGGATGTAA	GTTTGCTGGATGTAA	3	1
AGTTAACCAAGGTAT	AGTTAACCAAGGTAT	1	1
TTTACTTGGACGTTT	TTTACTTGGACGTTT	1	1
GGGGGACAATGAATA	GGGGGACAATGAATA	1	1
TATCCCGATGACATA	TATCCCGATGACATA	3	1
GCGAGGTGAGGTATG	GCGAGGTGAGGTATG	1	1
CATCTTCCTCTTGAA	CATCTTCCTCTTGAA	1	1
ATCTTATTTCCTTCG	ATCTTATTTCCTTCG	1	1
TATTTGATCATACAC	TATTTGATCATACAC	3	1
TTAGATTTGATTTGT	TTAGATTTGATTTGT	1	1
ATAACTTTCGTCGTA	ATAACTTTCGTCGTA	1	1
ATTGGTACGGGTACG	ATTGGTACGGGTACG	1	1
TCAAGGCAGTACGGT	TCAAGGCAGTACGGT	1	1
CTTTCGTTGGTGGGC	CTTTCGTTGGTGGGC	2	1
GCATGGCCGTCCCTA	GCATGGCCGTCCCTA	1	1
GAGTGAAGCATAAAA	GAGTGAAGCATAAAA	1	1
TAAGTGACGAATAGT	TAAGTGACGAATAGT	1	1
CTTCCACTGGGTGTG	CTTCCACTGGGTGTG	1	1
ATAAGCATTTTGACT	ATAAGCATTTTGACT	1	1
ACCGCACTGGATTTT	ACCGCACTGGATTTT	1	1
GTGAAGAGGGGCGTA	GTGAAGAGGGGCGTA	4	1
TCTGCGAGGCGTTGG	TCTGCGAGGCGTTGG	2	1
GCTAGTTTAAGGTGC	GCTAGTTTAAGGTGC	3	1
AATGCGGTTAGCTTA	AATGCGGTTAGCTTA	2	1
CCAAGACAAATGTCA	CCAAGACAAATGTCA	2	1
GAACTAGTAAGTTTA	GAACTAGTAAGTTTA	3	1
ATGGGTTGGCTTTTC	ATGGGTTGGCTTTTC	1	1
CTACAGTACGGCCTT	CTACAGTACGGCCTT	3	1
TGCATGAAACTTATA	TGCATGAAACTTATA	1	1
TTTTTATAACGGGGA	TTTTTATAACGGGGA	3	1
TTATTAGCAAATGTT	TTATTAGCAAATGTT	4	1
ACATAAATGATAGTT	ACATAAATGATAGTT	1	1
TCTGTACGCGTGTTA	TCTGTACGCGTGTTA	1	1
TAAACTACACTATGT	TAAACTACACTATGT	2	1
ACGTGTGTGCCACCA	ACGTGTGTGCCACCA	5	1
TAATTGAAAATCCTG	TAATTGAAAATCCTG	2	1
TAGGCTGTACCCCTT	TAGGCTGTACCCCTT	3	1
AAAATCCATTTATGT	AAAATCCATTTATGT	1	1
TGGGTCGCGAGCTCT	TGGGTCGCGAGCTCT	1	1
AGTTTAGCTATTTTC	AGTTTAGCTATTTTC	1	1
TTCTTAGGCCACTAT	TTCTTAGGCCACTAT	1	1
TTCATTCCGGCGCTC	TTCATTCCGGCGCTC	1	1
TTGATAGAATTAGCA	TTGATAGAATTAGCA	1	1
GCGGGGTTGTGAAAA	GCGGGGTTGTGAAAA	1	1
GATTTGGCTTAATTA	GATTTGGCTTAATTA	1	1
GGAGAGGGTGGTTTA	GGAGAGGGTGGTTTA	1	1
AGTTCATACTTTACT	AGTTCATACTTTACT	2	1
AACTGAATGTGAAGA	AACTGAATGTGAAGA	1	1
TTATTCCGGCTTCAT	TTATTCCGGCTTCAT	2	1
TATGTTTTATCGCAC	TATGTTTTATCGCAC	3	1
GTAGTTATCCTTCAC	GTAGTTATCCTTCAC	1	1
CCACAAGCTATTCTT	CCACAAGCTATTCTT	1	1
TCTTGATAAATACCT	TCTTGATAAATACCT	5	1
GCGTGCCGGGGTCCG	GCGTGCCGGGGTCCG	2	1
AATTCTTCTCTACTT	AATTCTTCTCTACTT	1	1
GTTCGAATCCGATAA	GTTCGAATCCGATAA	1	1
TATGTGGCTTTCTTC	TATGTGGCTTTCTTC	1	1
GGCGTGGTCCTGGGT	GGCGTGGTCCTGGGT	1	1
AATGTCTATATTGTC	AATGTCTATATTGTC	1	1
AGGCATGCGCCCTGG	AGGCATGCGCCCTGG	1	1
CTTTTGTTTTTTGTG	CTTTTGTTTTTTGTG	1	1
AAATGCGTCGATCCT	AAATGCGTCGATCCT	2	1
GTAGGGCAAGGTGGG	GTAGGGCAAGGTGGG	1	1
GGTTGGGATGCCATC	GGTTGGGATGCCATC	3	1
GATTGTGCAGTTTTC	GATTGTGCAGTTTTC	1	1
TATCGTATATCTTCT	TATCGTATATCTTCT	1	1
GCGGGTTACTAACTC	GCGGGTTACTAACTC	2	1
CGCTGACGTAATGGT	CGCTGACGTAATGGT	2	1
ACTGCTGCCCTTTCA	ACTGCTGCCCTTTCA	2	1
TAATCGACTGAACCT	TAATCGACTGAACCT	1	1
GTGTGGTGGGGCGAA	GTGTGGTGGGGCGAA	1	1
TAGTGAATAGTTAAT	TAGTGAATAGTTAAT	1	1
GCGGTCTACTTCGTA	GCGGTCTACTTCGTA	2	1
CCGCTAATACTAGGT	CCGCTAATACTAGGT	1	1
ACTGCGCCTTGAGAA	ACTGCGCCTTGAGAA	1	1
GAGTTCGCGAAATTA	GAGTTCGCGAAATTA	1	1
AGTCTTCACTAGGTT	AGTCTTCACTAGGTT	3	1
TTTAGGAGGATTTAT	TTTAGGAGGATTTAT	5	1
AACTCACCAATTAAT	AACTCACCAATTAAT	3	1
TCCGATATCAGTTTA	TCCGATATCAGTTTA	3	1
CGGCTTTTTGACGAA	CGGCTTTTTGACGAA	1	1
TAGGAGGTGGGGTGT	TAGGAGGTGGGGTGT	1	1
CTAATTGGTTCCATT	CTAATTGGTTCCATT	1	1
GTTTCATTCCACTCA	GTTTCATTCCACTCA	4	1
TTATGGGTTAAAATT	TTATGGGTTAAAATT	1	1
TGATTTATCAATGGT	TGATTTATCAATGGT	1	1
GCAAAGTATTAGTAA	GCAAAGTATTAGTAA	1	1
ACAGTCGGGGTGTAT	ACAGTCGGGGTGTAT	1	1
CTTATGCACCAAGTG	CTTATGCACCAAGTG	3	1
TGGCGGCGTAAGGGT	TGGCGGCGTAAGGGT	1	1
AGCTGTATTCCTTGG	AGCTGTATTCCTTGG	2	1
GTGAACCTTTCGGTA	GTGAACCTTTCGGTA	1	1
TCACCTACAAGACAT	TCACCTACAAGACAT	4	1
ACAATAAATCATTTT	ACAATAAATCATTTT	4	1
ACACCTCTCGCTATA	ACACCTCTCGCTATA	1	1
ATGCGCTATTTAATT	ATGCGCTATTTAATT	1	1
GTGATAGAAGGGTGA	GTGATAGAAGGGTGA	3	1
GCAGCGGTGAGCATC	GCAGCGGTGAGCATC	3	1
TTTATTGGGCTACAT	TTTATTGGGCTACAT	2	1
TTCATGCGTGGAACT	TTCATGCGTGGAACT	3	1
GTGTTCTTAACGCGG	GTGTTCTTAACGCGG	1	1
TATCGTGCTACTGCT	TATCGTGCTACTGCT	1	1
AAATTTACGGAGAAA	AAATTTACGGAGAAA	1	1
GTGCGGGCTGAGTGG	GTGCGGGCTGAGTGG	1	1
GGAATTAAATTCTCC	GGAATTAAATTCTCC	2	1
AACATAATTAGTTAA	AACATAATTAGTTAA	2	1
GAATCGGCTTTGATG	GAATCGGCTTTGATG	3	1
CTAAAGCCAAAAGTA	CTAAAGCCAAAAGTA	1	1
ACTTAGTTACATGTT	ACTTAGTTACATGTT	1	1
GATTATGACATCATG	GATTATGACATCATG	1	1
GGTATCAGGGTTCAG	GGTATCAGGGTTCAG	2	1
GATGGGTATGCGCGT	GATGGGTATGCGCGT	1	1
CCGTTATGAATTTTG	CCGTTATGAATTTTG	1	1
GCATCGTGAGGGCTC	GCATCGTGAGGGCTC	1	1
ACTCTCATGCAGGGG	ACTCTCATGCAGGGG	1	1
ACCGCGGGCAAGGTG	ACCGCGGGCAAGGTG	2	1
ACAGCGACAATGAAT	ACAGCGACAATGAAT	1	1
GCAATTGTTAGTCTG	GCAATTGTTAGTCTG	1	1
GGAACCCATCCGATG	GGAACCCATCCGATG	3	1
GTCTCCTACTGGATC	GTCTCCTACTGGATC	5	1
TTGCGTCTAGATAGA	TTGCGTCTAGATAGA	1	1
TTGCTAATTTGCCGA	TTGCTAATTTGCCGA	1	1
CTTGTCGGGTTGGGA	CTTGTCGGGTTGGGA	1	1
AGGTGTCTATTAGTT	AGGTGTCTATTAGTT	2	1
TGTCGTGAGAAGGTA	TGTCGTGAGAAGGTA	1	1
GACTGAGCGTCGATT	GACTGAGCGTCGATT	1	1
CAATCAGTATTGCGA	CAATCAGTATTGCGA	1	1
GAAATTGTGTAGAAA	GAAATTGTGTAGAAA	1	1
GAAATTCACGACGAT	GAAATTCACGACGAT	1	1
TCACAAAAGCCCTTG	TCACAAAAGCCCTTG	1	1
ATCGCCGGGGTAGCG	ATCGCCGGGGTAGCG	1	1
TAAAAATGTTTCAAG	TAAAAATGTTTCAAG	1	1
AAGATTGAATATTTG	AAGATTGAATATTTG	2	1
GTAGCAGCTTCTTTA	GTAGCAGCTTCTTTA	3	1
GCCTAGAACCGGTTA	GCCTAGAACCGGTTA	1	1
CGCAGTGTCTCTAAA	CGCAGTGTCTCTAAA	1	1
TATCGTTACCAGTAG	TATCGTTACCAGTAG	2	1
GAACAACCTGCGGGT	GAACAACCTGCGGGT	2	1
TCTTAGATATCCACT	TCTTAGATATCCACT	2	1
AATATGTTGAAAGCG	AATATGTTGAAAGCG	3	1
TCATTTATGTAATGG	TCATTTATGTAATGG	1	1
CGAACCTCCTTCATT	CGAACCTCCTTCATT	1	1
GCTTGAATATCATAT	GCTTGAATATCATAT	1	1
CGCAGGACTTGCGCA	CGCAGGACTTGCGCA	5	1
ATCCTATATATGGTT	ATCCTATATATGGTT	1	1
AAAGGTAGACCGAGT	AAAGGTAGACCGAGT	2	1
TGATTTAGCCAGATA	TGATTTAGCCAGATA	2	1
GGGCAAATCGTACGG	GGGCAAATCGTACGG	4	1
GTATCCATTCAACAT	GTATCCATTCAACAT	3	1
ATTGTTTGCGGCTCA	ATTGTTTGCGGCTCA	1	1
GTCTATCGGTCTTCT	GTCTATCGGTCTTCT	1	1
GATACCCATAATCAA	GATACCCATAATCAA	1	1
TAAAACTAGTTGTCA	TAAAACTAGTTGTCA	5	1
TAGCTGATGGAGGTA	TAGCTGATGGAGGTA	3	1
TAACATTTCATCTAA	TAACATTTCATCTAA	5	1
AATACTGTCAAACCT	AATACTGTCAAACCT	1	1
AAATAGCGTATGGTA	AAATAGCGTATGGTA	2	1
CTTTGATCACAAGTG	CTTTGATCACAAGTG	1	1
TCCTGATTATACTAA	TCCTGATTATACTAA	1	1
TTGCTATCTCAAACT	TTGCTATCTCAAACT	3	1
TGGAAATATGATCAT	TGGAAATATGATCAT	2	1
GAATAGTATTGATTT	GAATAGTATTGATTT	1	1
ATAGTCCGGCTCACG	ATAGTCCGGCTCACG	3	1
AAGCTACATATTGCA	AAGCTACATATTGCA	1	1
GATTCGGCTAGTCTT	GATTCGGCTAGTCTT	1	1
TCACTGTCTTCCGTA	TCACTGTCTTCCGTA	2	1
ATCCGTCTGTTCCTA	ATCCGTCTGTTCCTA	2	1
CTTATGCTGTGTTCT	CTTATGCTGTGTTCT	5	1
AACACACCGCTACGC	AACACACCGCTACGC	3	1
ATTATGTGTTTCAGG	ATTATGTGTTTCAGG	1	1
TCTAGAACTTGCGGA	TCTAGAACTTGCGGA	1	1
TCACTCCGCGGGCGG	TCACTCCGCGGGCGG	3	1
CATCATTATGATATT	CATCATTATGATATT	1	1
CATAGAATATAACAA	CATAGAATATAACAA	1	1
TATCGTTATCCTATT	TATCGTTATCCTATT	2	1
GGTGACGTCATTGCA	GGTGACGTCATTGCA	1	1
GCTTTTGTGTCGTGT	GCTTTTGTGTCGTGT	1	1
ATCGATGTCTTGTTT	ATCGATGTCTTGTTT	2	1
TAGTGAGTTGTAAGA	TAGTGAGTTGTAAGA	2	1
AATCTTACCATTACG	AATCTTACCATTACG	1	1
AATCCACATGCAATA	AATCCACATGCAATA	1	1
GAAAATGGTTAGGAT	GAAAATGGTTAGGAT	3	1
GCGGCACAGGGATGG	GCGGCACAGGGATGG	1	1
ATGAGTGTGTTGCAT	ATGAGTGTGTTGCAT	1	1
GTCTCATGACATTAC	GTCTCATGACATTAC	1	1
TTAAAGGCTTCCGAT	TTAAAGGCTTCCGAT	2	1
GGATGTATGGATCTT	GGATGTATGGATCTT	1	1
TTAATCTTTTGTTTA	TTAATCTTTTGTTTA	3	1
TTAAAGCGTTAGTTT	TTAAAGCGTTAGTTT	4	1
GACGTTGCAAAGGGA	GACGTTGCAAAGGGA	9	1
CCCATAGTGCGTTTT	CCCATAGTGCGTTTT	1	1
GGCAGTGTGCTATTC	GGCAGTGTGCTATTC	2	1
AGGTAGATCTGATTC	AGGTAGATCTGATTC	1	1
CTTTCCAGCGTTTAC	CTTTCCAGCGTTTAC	1	1
GGGAGGGGGGAAGAG	GGGAGGGGGGAAGAG	3	1
CGGTTGAGAACTAGT	CGGTTGAGAACTAGT	1	1
GGATACTTTTCTCTA	GGATACTTTTCTCTA	1	1
GGGGGTACAAATAAC	GGGGGTACAAATAAC	1	1
CGAACCAGCGGAGCT	CGAACCAGCGGAGCT	1	1
GACGTAACACATTAA	GACGTAACACATTAA	1	1
CAAGTTCCGTTCTAT	CAAGTTCCGTTCTAT	1	1
AGTGGGGGAGGATGG	AGTGGGGGAGGATGG	4	1
GCCAGATAACCAAGC	GCCAGATAACCAAGC	3	1
ACATCTGAAACTATT	ACATCTGAAACTATT	2	1
GTGGAGGCGAGGCCG	GTGGAGGCGAGGCCG	3	1
ATTGTGCCGTCATAG	ATTGTGCCGTCATAG	1	1
TTAGCCATATATGTT	TTAGCCATATATGTT	2	1
ATATCGGGGATGTGT	ATATCGGGGATGTGT	2	1
TTGTAGTTGTCATCT	TTGTAGTTGTCATCT	1	1
AGATTTCTTGAATGG	AGATTTCTTGAATGG	1	1
TGTTAATACCGTATT	TGTTAATACCGTATT	1	1
TCCATGCCCTATATC	TCCATGCCCTATATC	2	1
CAGCGTGTAGATGTT	CAGCGTGTAGATGTT	4	1
GTTCTCGAAATGTTG	GTTCTCGAAATGTTG	3	1
TTAATCTTATAAACT	TTAATCTTATAAACT	1	1
GTTTCCTGCCATTTA	GTTTCCTGCCATTTA	1	1
GGTCTTTATTTGGCC	GGTCTTTATTTGGCC	2	1
GGAGATGATTAGATA	GGAGATGATTAGATA	1	1
TAAAGAGTTAATAGT	TAAAGAGTTAATAGT	1	1
TCCAGATGTATATAA	TCCAGATGTATATAA	3	1
CAGTAACTTGCTAGT	CAGTAACTTGCTAGT	1	1
CGATATACGTACTCA	CGATATACGTACTCA	1	1
CCCAGCATGAATAAA	CCCAGCATGAATAAA	1	1
TAACTCCAGCTGATT	TAACTCCAGCTGATT	2	1
TAATCAAGTCCCATC	TAATCAAGTCCCATC	2	1
TATCCCAGTTCATGA	TATCCCAGTTCATGA	2	1
TGCGGAGAGATTGTA	TGCGGAGAGATTGTA	1	1
TCCACTTTCATTAGT	TCCACTTTCATTAGT	1	1
TATTCCAGCGTCATC	TATTCCAGCGTCATC	1	1
GTTATCGGTTTGGTT	GTTATCGGTTTGGTT	1	1
ATTCAATACGTACTA	ATTCAATACGTACTA	1	1
AACCTATTCGTGCAT	AACCTATTCGTGCAT	1	1
TACGTTGGCTGTAAC	TACGTTGGCTGTAAC	3	1
AACTTTTTGGGAACG	AACTTTTTGGGAACG	1	1
TGCAGTTCCGTAGTC	TGCAGTTCCGTAGTC	2	1
GGTCACACTTTCTAT	GGTCACACTTTCTAT	2	1
ACTTGATCGGAGGCT	ACTTGATCGGAGGCT	2	1
AGGGCTGCAGAATCA	AGGGCTGCAGAATCA	2	1
CTAGGTGGGAAAATC	CTAGGTGGGAAAATC	1	1
GGTGACGTGTCTGTG	GGTGACGTGTCTGTG	1	1
CCGCTTGCATATGTT	CCGCTTGCATATGTT	1	1
GTAGTGCTCTTGTTA	GTAGTGCTCTTGTTA	1	1
CCTTCTCCGTAGTCG	CCTTCTCCGTAGTCG	1	1
GGTCTTTTGTTAGCA	GGTCTTTTGTTAGCA	1	1
AAGCTGTGGTCCTTA	AAGCTGTGGTCCTTA	2	1
ATCTAGATTATTAAC	ATCTAGATTATTAAC	4	1
ATTCTCATAAAGGCA	ATTCTCATAAAGGCA	1	1
CATTCCGTCAATAAT	CATTCCGTCAATAAT	1	1
TTATTAGCCCTAATC	TTATTAGCCCTAATC	2	1
CTGTCAAGCTCTGTA	CTGTCAAGCTCTGTA	3	1
TCAGTCTGAGTTCGG	TCAGTCTGAGTTCGG	1	1
CAACCTCGCAAGAGA	CAACCTCGCAAGAGA	2	1
CAATCGATATATGGG	CAATCGATATATGGG	1	1
GGTTTCACGATGTCG	GGTTTCACGATGTCG	8	1
TTTATTAACATCAAA	TTTATTAACATCAAA	1	1
TCCTTGATTGTTGGT	TCCTTGATTGTTGGT	2	1
ACCGTGTTGCATTTT	ACCGTGTTGCATTTT	1	1
TCCAATTCGTTTAAT	TCCAATTCGTTTAAT	3	1
AGGTTAAACCCTTCG	AGGTTAAACCCTTCG	7	1
AAGGGTTATTCTGCA	AAGGGTTATTCTGCA	1	1
GCATTTGGGCCTCAC	GCATTTGGGCCTCAC	1	1
GTCTAAGAGGCTTTC	GTCTAAGAGGCTTTC	1	1
CGTCGCTGCGTTGCT	CGTCGCTGCGTTGCT	2	1
TAACTTTTGAATTTT	TAACTTTTGAATTTT	2	1
TACCCGTACGAACGT	TACCCGTACGAACGT	1	1
GCAGGGGGCGAATGA	GCAGGGGGCGAATGA	1	1
GAGGGGGGAACGGGA	GAGGGGGGAACGGGA	1	1
TAAGATAAATCATCG	TAAGATAAATCATCG	1	1
TATAGGCACACATTT	TATAGGCACACATTT	1	1
AAAGAATTATTAGAA	AAAGAATTATTAGAA	2	1
GACGAGGGTGGATGT	GACGAGGGTGGATGT	1	1
CGTTGTGTAGTGCCC	CGTTGTGTAGTGCCC	1	1
CAGTTACGTATAACA	CAGTTACGTATAACA	3	1
GTTTTCCTTGCTTCA	GTTTTCCTTGCTTCA	1	1
TATGAATTATGACGG	TATGAATTATGACGG	2	1
GGGACATTGCTAGAT	GGGACATTGCTAGAT	1	1
GGCAGGGATGCCCGG	GGCAGGGATGCCCGG	4	1
TGCGCCATGGGGTTT	TGCGCCATGGGGTTT	9	1
CCTACTCTTAGACTT	CCTACTCTTAGACTT	2	1
CATTTTAGCCTAATT	CATTTTAGCCTAATT	1	1
CAACAAAGGCATTTA	CAACAAAGGCATTTA	1	1
ACTCTTACAGAAATT	ACTCTTACAGAAATT	2	1
GTTACGAACGCGTTA	GTTACGAACGCGTTA	1	1
GACGGTTGGGGGTGG	GACGGTTGGGGGTGG	1	1
AAGTGATAGCATTTA	AAGTGATAGCATTTA	1	1
CGCGCTTGTTCTATA	CGCGCTTGTTCTATA	2	1
TCTAAAAGGCCTCGT	TCTAAAAGGCCTCGT	2	1
CTCTGAAAAACTGCG	CTCTGAAAAACTGCG	1	1
TTAAAGTTGTCACTA	TTAAAGTTGTCACTA	1	1
TTCTGAACTATCATT	TTCTGAACTATCATT	1	1
GTAGCGGTTACGATC	GTAGCGGTTACGATC	1	1
TGCGATCAAAGGCTT	TGCGATCAAAGGCTT	2	1
AGTTGTCTTACGTAT	AGTTGTCTTACGTAT	1	1
TGCTGGACTCTTGTC	TGCTGGACTCTTGTC	1	1
ACAATAGCTAGCTTT	ACAATAGCTAGCTTT	1	1
TCAACGCAAATTTCC	TCAACGCAAATTTCC	1	1
TTCCTGGTAGGTCTT	TTCCTGGTAGGTCTT	1	1
GGAGGGGAAGTAGAG	GGAGGGGAAGTAGAG	2	1
TGATATTTTAACTCG	TGATATTTTAACTCG	2	1
TTATAGGTCGCAGTA	TTATAGGTCGCAGTA	2	1
TAACTGTGGCACTCT	TAACTGTGGCACTCT	1	1
TTAGCGGGGCGAAAC	TTAGCGGGGCGAAAC	4	1
AGTTCACTGCTGGCA	AGTTCACTGCTGGCA	1	1
GGCGATCTTTTTTGT	GGCGATCTTTTTTGT	1	1
ATCTTTTATACGATT	ATCTTTTATACGATT	1	1
TCATCCGGTACCTTC	TCATCCGGTACCTTC	6	1
TCGTACTGTGTCTTT	TCGTACTGTGTCTTT	1	1
ACTCTGGTCGCTCCA	ACTCTGGTCGCTCCA	1	1
TATAATAGGTAAGTT	TATAATAGGTAAGTT	4	1
GACACGATTTCGTGT	GACACGATTTCGTGT	1	1
ATCCCTCCAAGATTT	ATCCCTCCAAGATTT	2	1
CCAGGCTTGTAGGGT	CCAGGCTTGTAGGGT	1	1
GCCAGCGATAAATCT	GCCAGCGATAAATCT	2	1
GATATATCGTACATG	GATATATCGTACATG	1	1
TCCGGGGGATCGCAG	TCCGGGGGATCGCAG	1	1
CTAACTTCCGGGCTT	CTAACTTCCGGGCTT	1	1
ATCTCCATGTTAACT	ATCTCCATGTTAACT	1	1
TTGATATTCATCATT	TTGATATTCATCATT	2	1
AATGTGTTTATGTAT	AATGTGTTTATGTAT	1	1
TTGAAACCCGTTTCT	TTGAAACCCGTTTCT	1	1
TTGACGTTGGATCGT	TTGACGTTGGATCGT	2	1
CTCAGGTTGGTATAC	CTCAGGTTGGTATAC	3	1
TTTGAACATCATCAG	TTTGAACATCATCAG	4	1
ACAAACTAGAATCGT	ACAAACTAGAATCGT	1	1
CTAGATAATTTCCAC	CTAGATAATTTCCAC	2	1
GAAGGGCCAGCTCAA	GAAGGGCCAGCTCAA	4	1
CTTTCAGAAGACCAA	CTTTCAGAAGACCAA	1	1
CGATGTTTGGCTCTA	CGATGTTTGGCTCTA	1	1
TTAATATGTTTTTAC	TTAATATGTTTTTAC	5	1
TCAAGGTGTAGGCGG	TCAAGGTGTAGGCGG	2	1
CGACTTGATATTACG	CGACTTGATATTACG	3	1
GAGCTATGTATATAT	GAGCTATGTATATAT	1	1
TTCGCTGGCATCTTG	TTCGCTGGCATCTTG	3	1
GTTGTGTCGTCCTTG	GTTGTGTCGTCCTTG	1	1
TCGCGCGAGACATAA	TCGCGCGAGACATAA	1	1
ACTCAGTACTGATTT	ACTCAGTACTGATTT	1	1
TTACCACTGTCGTCT	TTACCACTGTCGTCT	1	1
AAATGTATCAAGGAG	AAATGTATCAAGGAG	1	1
AATGCCGAATGATAT	AATGCCGAATGATAT	1	1
ATTCCGTTCCACTAC	ATTCCGTTCCACTAC	1	1
CAAATATCTCTTTTT	CAAATATCTCTTTTT	5	1
TATGCGCGCTCTCCA	TATGCGCGCTCTCCA	3	1
TGCATTCTTTCCCAA	TGCATTCTTTCCCAA	1	1
TTTATTAGTAACCAA	TTTATTAGTAACCAA	2	1
TCTACCTATATTTTA	TCTACCTATATTTTA	2	1
CTACTAACGCGATTA	CTACTAACGCGATTA	3	1
ACGATAAGAACAACA	ACGATAAGAACAACA	1	1
GGACACTAATAGTGG	GGACACTAATAGTGG	1	1
TTTCGTCTCGTTCGT	TTTCGTCTCGTTCGT	1	1
CGTTAATTACCGTGA	CGTTAATTACCGTGA	3	1
TATGGGTCGATAGAT	TATGGGTCGATAGAT	1	1
GACTACCTGTACGTT	GACTACCTGTACGTT	5	1
GGCGGTTAGGTTGGT	GGCGGTTAGGTTGGT	2	1
ATGCAATCGGAAAAA	ATGCAATCGGAAAAA	1	1
AAACGCTCCGGTCCT	AAACGCTCCGGTCCT	1	1
AACGGTTTGATTAAT	AACGGTTTGATTAAT	1	1
TGTTTGATATTTTTA	TGTTTGATATTTTTA	1	1
ACAGTGTCAAAGGGA	ACAGTGTCAAAGGGA	2	1
CTTGGGGGGGCTGAG	CTTGGGGGGGCTGAG	1	1
ATGATGCGCCAGCAT	ATGATGCGCCAGCAT	1	1
TATTAACAACAGTAT	TATTAACAACAGTAT	2	1
TTTTGAGTTTATCAA	TTTTGAGTTTATCAA	1	1
ACCCTTGTTTCACGT	ACCCTTGTTTCACGT	2	1
GCTTCGATAGTTCAA	GCTTCGATAGTTCAA	1	1
TAGCAAGAAATCAGC	TAGCAAGAAATCAGC	4	1
GTTGGAAAATTAAGG	GTTGGAAAATTAAGG	1	1
CTTTACAAAGGACTA	CTTTACAAAGGACTA	1	1
CAAGCTTAACAGGGA	CAAGCTTAACAGGGA	1	1
ACTGCTCGATTTCCG	ACTGCTCGATTTCCG	1	1
ATAGTCGCATTGCAT	ATAGTCGCATTGCAT	1	1
AATTTAAGATATATT	AATTTAAGATATATT	1	1
TCCTGACCCTTGACA	TCCTGACCCTTGACA	2	1
TTGCGTTCTTATTTA	TTGCGTTCTTATTTA	3	1
AAGATCACCCATTGG	AAGATCACCCATTGG	2	1
TGTACTGGTGTTGAC	TGTACTGGTGTTGAC	7	1
CGTGACGGGGATGCA	CGTGACGGGGATGCA	1	1
CTACGTAATTTAAAG	CTACGTAATTTAAAG	4	1
GCAGGCTTAGATATC	GCAGGCTTAGATATC	2	1
GCACTGTATTAAGTA	GCACTGTATTAAGTA	1	1
GAGATTATTTTAAAT	GAGATTATTTTAAAT	2	1
GTCGCTATTCTCCAG	GTCGCTATTCTCCAG	2	1
TATAGAGCACTCTGT	TATAGAGCACTCTGT	1	1
AAAGTAATGTAATTG	AAAGTAATGTAATTG	1	1
TCATTGCGTCTCAAC	TCATTGCGTCTCAAC	1	1
TCACCTACAATAAGT	TCACCTACAATAAGT	7	1
CTTTTTTTAGAGCTA	CTTTTTTTAGAGCTA	1	1
AAGCGGTACTATCAA	AAGCGGTACTATCAA	3	1
GTAGACACGTATATC	GTAGACACGTATATC	2	1
CGACCTTTCCATGCG	CGACCTTTCCATGCG	2	1
AGAGTTAGTTCCGGT	AGAGTTAGTTCCGGT	3	1
TCACAGCCTGAGATT	TCACAGCCTGAGATT	1	1
ACTTCGCACTACGTT	ACTTCGCACTACGTT	1	1
AATCGTGTGGTAAGG	AATCGTGTGGTAAGG	1	1
TTTACTACAGCCTAC	TTTACTACAGCCTAC	3	1
TCGTAGCATAACAAA	TCGTAGCATAACAAA	3	1
TTAAGACCCGATTTG	TTAAGACCCGATTTG	2	1
CAGTCCGGTAGTTAA	CAGTCCGGTAGTTAA	2	1
CGGAACAGCTAACTA	CGGAACAGCTAACTA	1	1
ATTTTATCCTACTGT	ATTTTATCCTACTGT	3	1
ATCGTGAACAAGTTA	ATCGTGAACAAGTTA	1	1
TAGAGCTTTAAACTT	TAGAGCTTTAAACTT	1	1
ACCATTCATTAAAAT	ACCATTCATTAAAAT	2	1
CCTTTAGCTCATTAA	CCTTTAGCTCATTAA	1	1
AGGGGGAAATTCTTA	AGGGGGAAATTCTTA	1	1
GCGTGAGGCTGCGCG	GCGTGAGGCTGCGCG	2	1
GACATAAGCAACTTT	GACATAAGCAACTTT	2	1
TTGGGGAAACACCAT	TTGGGGAAACACCAT	2	1
ACAACTAGTACTTCC	ACAACTAGTACTTCC	1	1
ACTACATTCGGGTAT	ACTACATTCGGGTAT	3	1
ATCATCTTCCATTTT	ATCATCTTCCATTTT	1	1
TGTGGGTGTTTTAAC	TGTGGGTGTTTTAAC	2	1
TGCTTTCTAGAAATA	TGCTTTCTAGAAATA	2	1
CCTGTCAGCTGCTTC	CCTGTCAGCTGCTTC	2	1
TTCACCAATTGATAG	TTCACCAATTGATAG	2	1
CGTTTGCTGAGTGTA	CGTTTGCTGAGTGTA	1	1
TGGTTTTTTAACACG	TGGTTTTTTAACACG	1	1
GGATAGGGATTACAA	GGATAGGGATTACAA	1	1
TGGGTCTAAGTTTAT	TGGGTCTAAGTTTAT	2	1
CAACACTGCCAATTG	CAACACTGCCAATTG	1	1
TTATCTAGGGTTGTT	TTATCTAGGGTTGTT	4	1
CCCATGACTTTCTCA	CCCATGACTTTCTCA	1	1
CACCTTTCGCACTAA	CACCTTTCGCACTAA	1	1
TGCTGCCTTCTAGTT	TGCTGCCTTCTAGTT	3	1
ACTCTTTTTTTGCTT	ACTCTTTTTTTGCTT	2	1
TACAATGAACCTCAA	TACAATGAACCTCAA	1	1
AAGAAGGTAATGGAA	AAGAAGGTAATGGAA	1	1
ATATGACGTGGTCTG	ATATGACGTGGTCTG	1	1
TACGGTTTAAATGTC	TACGGTTTAAATGTC	3	1
GATTGGTCATTGTAT	GATTGGTCATTGTAT	1	1
TCAAAAAAGCTTTCA	TCAAAAAAGCTTTCA	1	1
CACTACATCTGTCAT	CACTACATCTGTCAT	1	1
TGTATGGGGGTGTCG	TGTATGGGGGTGTCG	1	1
TGAATAGGCAGTATC	TGAATAGGCAGTATC	1	1
GTAGGCAGATCCTCA	GTAGGCAGATCCTCA	1	1
GGTCGTCTATATGTA	GGTCGTCTATATGTA	1	1
CCTTCTCGACAGATT	CCTTCTCGACAGATT	3	1
ATTCATGATACGTAT	ATTCATGATACGTAT	2	1
ATTCCGGAATTTGCT	ATTCCGGAATTTGCT	4	1
TTCTGGAAGGTGGCA	TTCTGGAAGGTGGCA	1	1
GCGGCGCGGCGCGGC	GCGGCGCGGCGCGGC	2	1
GAAGCCAAAGCGAAA	GAAGCCAAAGCGAAA	2	1
GAATTTAACTGCTTT	GAATTTAACTGCTTT	1	1
ATGGCAACTGTGTTA	ATGGCAACTGTGTTA	1	1
ATCGCGGGTCTTTCA	ATCGCGGGTCTTTCA	1	1
CCTACTTTCGCATGA	CCTACTTTCGCATGA	1	1
ATAAGAGTACCGATA	ATAAGAGTACCGATA	1	1
GGTCCAGCGCTCCAG	GGTCCAGCGCTCCAG	3	1
GCATCGAAGATCGGG	GCATCGAAGATCGGG	1	1
GAGCGATATGGGGGG	GAGCGATATGGGGGG	2	1
TGTACCGCCTAAATC	TGTACCGCCTAAATC	1	1
AACGTCTCATTTTCA	AACGTCTCATTTTCA	1	1
ATAGAAGGCTAATTG	ATAGAAGGCTAATTG	3	1
TTCTGTGAGCGGGAG	TTCTGTGAGCGGGAG	3	1
TTTACTAACGTTTAT	TTTACTAACGTTTAT	3	1
AGTCAATCAAGATGA	AGTCAATCAAGATGA	3	1
GAAGTCCTAGCTAAC	GAAGTCCTAGCTAAC	2	1
CGTTACTCGAAAAAC	CGTTACTCGAAAAAC	2	1
GCAAGGACGCCAATG	GCAAGGACGCCAATG	1	1
TCAGATGCTCGCACT	TCAGATGCTCGCACT	1	1
GGATCATGTGCGTGT	GGATCATGTGCGTGT	2	1
AAAAGTATCAAGTCT	AAAAGTATCAAGTCT	1	1
CCTAACTGTTATGTG	CCTAACTGTTATGTG	1	1
ACGGGGGATTTAAGA	ACGGGGGATTTAAGA	1	1
GGTCTCCCTGGTTAT	GGTCTCCCTGGTTAT	1	1
GGGTACGTATTTCGG	GGGTACGTATTTCGG	1	1
CAGTAAGTTTAAACC	CAGTAAGTTTAAACC	3	1
GCTCGTTGTCAAAGG	GCTCGTTGTCAAAGG	1	1
ATCGGGAAGTAGGGG	ATCGGGAAGTAGGGG	2	1
TCACACAATCATTGG	TCACACAATCATTGG	3	1
TTATAACCCTCCCTG	TTATAACCCTCCCTG	1	1
AGCTGTCCTGCTACG	AGCTGTCCTGCTACG	1	1
AGTGCTTACTGATCA	AGTGCTTACTGATCA	3	1
TGGTTACGTTCCTTT	TGGTTACGTTCCTTT	2	1
TCATGTTCAACGTAA	TCATGTTCAACGTAA	1	1
TTGAAGTGTTATAGT	TTGAAGTGTTATAGT	2	1
AAGTATGTTATGTAC	AAGTATGTTATGTAC	2	1
TTCGGACGCACACTA	TTCGGACGCACACTA	1	1
TATGTTTTACGAACC	TATGTTTTACGAACC	1	1
CCTTCGAAGTCTCTT	CCTTCGAAGTCTCTT	2	1
CATTACATCCATAGG	CATTACATCCATAGG	1	1
TGTAGTCGATATAAT	TGTAGTCGATATAAT	1	1
ATTTAATAACTTGAA	ATTTAATAACTTGAA	1	1
TGGCAATTCAACATT	TGGCAATTCAACATT	1	1
TTAGTCAGCTTTGTC	TTAGTCAGCTTTGTC	4	1
TGCTTTGCGTTTGTA	TGCTTTGCGTTTGTA	3	1
CGTAGACTGTCATGG	CGTAGACTGTCATGG	1	1
TCGGCTAAAGTTATT	TCGGCTAAAGTTATT	1	1
TACTATATCCAAGGA	TACTATATCCAAGGA	2	1
TCCATTAAGTATTTG	TCCATTAAGTATTTG	1	1
TCTTCAAATATATTT	TCTTCAAATATATTT	1	1
AGATATGTAAACTGT	AGATATGTAAACTGT	2	1
GGACTATGGAGTGCG	GGACTATGGAGTGCG	1	1
GTAGAAATAGGTTAT	GTAGAAATAGGTTAT	2	1
GGTCGTGAGGGGAGG	GGTCGTGAGGGGAGG	2	1
ATATGTTTTCGCCTT	ATATGTTTTCGCCTT	1	1
GATACTTCTAGGCTT	GATACTTCTAGGCTT	3	1
TCTACAGGCTATTTA	TCTACAGGCTATTTA	1	1
AGGAGTGGTAGAAGT	AGGAGTGGTAGAAGT	1	1
TTCTTTTGGTTCATA	TTCTTTTGGTTCATA	1	1
GAACTGATAGTTTAT	GAACTGATAGTTTAT	1	1
GGGTAGTAACACAGT	GGGTAGTAACACAGT	1	1
AATTTTTCTCTGAAC	AATTTTTCTCTGAAC	1	1
GTACCATTGGCCTAT	GTACCATTGGCCTAT	6	1
CGTCTTACTCTTACT	CGTCTTACTCTTACT	4	1
AATGAACTTCACTTC	AATGAACTTCACTTC	1	1
GGCTGCGGGAGACCC	GGCTGCGGGAGACCC	1	1
GTTATTGTTTACACT	GTTATTGTTTACACT	1	1
CGACGTCGGTTGAGG	CGACGTCGGTTGAGG	1	1
GTGACGGGATGATTC	GTGACGGGATGATTC	4	1
ACATTTCGGATCTCG	ACATTTCGGATCTCG	1	1
CAATGCACGGATTGT	CAATGCACGGATTGT	1	1
CTGCGGTATAAGCCG	CTGCGGTATAAGCCG	2	1
TGCTTCAAAAACTAT	TGCTTCAAAAACTAT	1	1
AGTTGCACATGCGAA	AGTTGCACATGCGAA	1	1
AGGTCATATCCCACG	AGGTCATATCCCACG	2	1
CTAGTGGTCACCACT	CTAGTGGTCACCACT	1	1
GGTGCGATCAGTAGA	GGTGCGATCAGTAGA	5	1
TTTTATAATAGGATG	TTTTATAATAGGATG	1	1
TTAGTTGGGTACGCT	TTAGTTGGGTACGCT	1	1
GACGGGGAGGGTTAT	GACGGGGAGGGTTAT	3	1
TTCATTTCAAATCTT	TTCATTTCAAATCTT	1	1
GGGGAGAGAGCGACG	GGGGAGAGAGCGACG	3	1
TTGTAACGATTGAGA	TTGTAACGATTGAGA	2	1
TTGATCTCGTTACCT	TTGATCTCGTTACCT	1	1
ATATCACAGAATATC	ATATCACAGAATATC	2	1
GAAACTTATTAGTAT	GAAACTTATTAGTAT	2	1
GTTTGTCGTGTTATC	GTTTGTCGTGTTATC	2	1
ATTACCAGAGAGACG	ATTACCAGAGAGACG	2	1
ATTTTGTCTTCTTTG	ATTTTGTCTTCTTTG	1	1
AATTGCTACGAAATT	AATTGCTACGAAATT	1	1
ATTTCATCGATAGCG	ATTTCATCGATAGCG	4	1
AGAGTTGCTGCATAT	AGAGTTGCTGCATAT	3	1
GTTTGTTGTTTTTGA	GTTTGTTGTTTTTGA	6	1
GGTGTTGCGATATAT	GGTGTTGCGATATAT	1	1
TTTCCAAGTGTGTTG	TTTCCAAGTGTGTTG	1	1
TAAATTAAGTCCATT	TAAATTAAGTCCATT	2	1
CCCGCGAGTATGCTG	CCCGCGAGTATGCTG	1	1
CGAGTCATTCCATGT	CGAGTCATTCCATGT	1	1
TACAAATGTTCAACA	TACAAATGTTCAACA	3	1
GAACCTTTTAGGCAA	GAACCTTTTAGGCAA	1	1
CTTGTGCGGTAATGG	CTTGTGCGGTAATGG	2	1
GTTACAGATCAAGTA	GTTACAGATCAAGTA	6	1
GGGCTAGCAGACATC	GGGCTAGCAGACATC	2	1
AGCGTATAATTTGCG	AGCGTATAATTTGCG	1	1
AAAGTATCTCTTCAG	AAAGTATCTCTTCAG	2	1
GATGTTTTTTCGCGT	GATGTTTTTTCGCGT	2	1
CTCGTTACGGCTAAA	CTCGTTACGGCTAAA	3	1
GCAACAACGTAGGAT	GCAACAACGTAGGAT	1	1
GCTGAACCAATGATT	GCTGAACCAATGATT	1	1
GGTTCGCTGCCTGTG	GGTTCGCTGCCTGTG	1	1
CTCGTTGGGCGCAGT	CTCGTTGGGCGCAGT	1	1
TGCGAAAAGTTTTAT	TGCGAAAAGTTTTAT	3	1
GGGCCATAACATTAG	GGGCCATAACATTAG	3	1
GGAAAAATGATCACG	GGAAAAATGATCACG	1	1
AACCGATTTCATATA	AACCGATTTCATATA	1	1
TATCATTCCTATTGT	TATCATTCCTATTGT	1	1
GTCGGCGGCGTGCGT	GTCGGCGGCGTGCGT	1	1
TTTTTGTGAGAACGT	TTTTTGTGAGAACGT	1	1
ACAGGCGTCAAAGTG	ACAGGCGTCAAAGTG	1	1
TAATGACCTCATTCA	TAATGACCTCATTCA	2	1
TACCATTGAAATGAA	TACCATTGAAATGAA	1	1
ATATTTCCAATACAA	ATATTTCCAATACAA	1	1
CATAGCTGAAACGAA	CATAGCTGAAACGAA	1	1
AGTCGGTGGAGGTGT	AGTCGGTGGAGGTGT	1	1
GCGGGTCATTGGCTA	GCGGGTCATTGGCTA	1	1
CGTCGTCAGGAAGCG	CGTCGTCAGGAAGCG	1	1
ACAGCTCTTTATCCT	ACAGCTCTTTATCCT	2	1
TGAATAAGGTTGGGT	TGAATAAGGTTGGGT	2	1
GCCTGTGTCACTCAC	GCCTGTGTCACTCAC	1	1
GTGTACTTCGTTATT	GTGTACTTCGTTATT	3	1
TCAATGTTCCATTCT	TCAATGTTCCATTCT	1	1
TTTAGTTCTTAGATC	TTTAGTTCTTAGATC	4	1
GGCTGCGCTTGTCCA	GGCTGCGCTTGTCCA	1	1
TACGGGCTGGGTGAT	TACGGGCTGGGTGAT	1	1
GTCGAAAGTAAGGTC	GTCGAAAGTAAGGTC	1	1
ATCGAGTATCATGAC	ATCGAGTATCATGAC	5	1
CCGGACATAGTTCGC	CCGGACATAGTTCGC	2	1
CTATCGACGCACTTT	CTATCGACGCACTTT	1	1
ACAACATGGGTCTTT	ACAACATGGGTCTTT	1	1
TATCGGGTCATTATC	TATCGGGTCATTATC	2	1
GAGTCCACTTTCTAA	GAGTCCACTTTCTAA	1	1
GGAAATTGTAAACTT	GGAAATTGTAAACTT	1	1
CGCACATTATAGGTC	CGCACATTATAGGTC	1	1
GAACTAGGCTGTCTT	GAACTAGGCTGTCTT	1	1
GTTATACTCGCACAT	GTTATACTCGCACAT	1	1
TTACGCAAGATCTAT	TTACGCAAGATCTAT	1	1
CTTGTTTAGGAGCAT	CTTGTTTAGGAGCAT	1	1
CTTCTACTCCATTCC	CTTCTACTCCATTCC	1	1
CTAATCGCTTTAATA	CTAATCGCTTTAATA	1	1
TCCTGAAGTTCAGCG	TCCTGAAGTTCAGCG	1	1
GTTATACCCGGGTCA	GTTATACCCGGGTCA	1	1
AGTGAAAAGAGTTCA	AGTGAAAAGAGTTCA	2	1
GCTGGCAACTCAACA	GCTGGCAACTCAACA	2	1
ATAAGTATAAAGAGT	ATAAGTATAAAGAGT	1	1
ATTGGTGAGCTAAGA	ATTGGTGAGCTAAGA	1	1
CGCTGTTGGGGAGTT	CGCTGTTGGGGAGTT	1	1
CGACCGTTTTGCGGT	CGACCGTTTTGCGGT	3	1
ATGCATGAGGAGTCA	ATGCATGAGGAGTCA	6	1
GTGTTTTATCGTTCA	GTGTTTTATCGTTCA	1	1
AAACGAAGTGCATAT	AAACGAAGTGCATAT	3	1
GGATTACAGTGGGGG	GGATTACAGTGGGGG	1	1
GACGCAAATTTGGTT	GACGCAAATTTGGTT	1	1
GGTCTGTCCTACTTG	GGTCTGTCCTACTTG	2	1
TGAAACTAAAAACGT	TGAAACTAAAAACGT	7	1
GAATAATAGGTCTTA	GAATAATAGGTCTTA	3	1
CACTTCTTTAGCTTA	CACTTCTTTAGCTTA	1	1
CAAACCTAACCTTAT	CAAACCTAACCTTAT	2	1
TGTTTGGGGCGAGTC	TGTTTGGGGCGAGTC	2	1
CATTGCTTATATAGC	CATTGCTTATATAGC	2	1
AGCGTTTCTTCGTAT	AGCGTTTCTTCGTAT	1	1
TAATCTTTCACTCCA	TAATCTTTCACTCCA	1	1
GTTTGACACACTTTT	GTTTGACACACTTTT	1	1
GCATAACAGGATCCG	GCATAACAGGATCCG	1	1
AATGGTGGGGGCAAG	AATGGTGGGGGCAAG	3	1
ACTGCAAGCGCGTTG	ACTGCAAGCGCGTTG	1	1
TTGGAGTGAGGTAGG	TTGGAGTGAGGTAGG	1	1
CTCCGGATGGGCGAT	CTCCGGATGGGCGAT	2	1
TCGGACCCAATCGGG	TCGGACCCAATCGGG	1	1
CCTTAGCTATATTTC	CCTTAGCTATATTTC	1	1
TCGTTAAGTTGCCGC	TCGTTAAGTTGCCGC	1	1
GCAAGTGCCCTATCT	GCAAGTGCCCTATCT	2	1
GTGCTTGGTGGATAC	GTGCTTGGTGGATAC	3	1
TATTATCCACAAAAA	TATTATCCACAAAAA	2	1
ATCGTGTACAATGGA	ATCGTGTACAATGGA	1	1
TGGAATCTACTACAT	TGGAATCTACTACAT	11	1
GGATGCAGGGGTATG	GGATGCAGGGGTATG	1	1
TGTCCTTACATTGAA	TGTCCTTACATTGAA	3	1
ACCTATAGAGCGGTG	ACCTATAGAGCGGTG	1	1
GATAGGCACGGGCTT	GATAGGCACGGGCTT	1	1
ATTGCGGTGCGCCAT	ATTGCGGTGCGCCAT	1	1
CTGCAATATATGTTA	CTGCAATATATGTTA	4	1
TAGGAGGCGGGGGTG	TAGGAGGCGGGGGTG	1	1
AAGCTGGCACAGCTT	AAGCTGGCACAGCTT	2	1
GGCATGTCTGGTCGG	GGCATGTCTGGTCGG	1	1
GCTATACAGTAACTT	GCTATACAGTAACTT	3	1
GTAGGGATCATTGTC	GTAGGGATCATTGTC	1	1
GCTGACAGAGCAAAA	GCTGACAGAGCAAAA	1	1
TTGATGTTAAATCTT	TTGATGTTAAATCTT	2	1
ATAGTGGGGATTATG	ATAGTGGGGATTATG	2	1
AGAATTCCCATTATT	AGAATTCCCATTATT	5	1
CACTATGTTCATAAT	CACTATGTTCATAAT	1	1
ATAGAAGGATGGTGA	ATAGAAGGATGGTGA	1	1
GCTCTCATAATGTTG	GCTCTCATAATGTTG	1	1
GGACTATGATTGACG	GGACTATGATTGACG	1	1
TGGGATACTCATAAG	TGGGATACTCATAAG	2	1
ATGACATCATTCATC	ATGACATCATTCATC	1	1
CTACAAAACGCTTTA	CTACAAAACGCTTTA	1	1
TATGCATCTGCGATA	TATGCATCTGCGATA	2	1
TAAGTTAATACTTCT	TAAGTTAATACTTCT	1	1
TATGAGAGATTTTCG	TATGAGAGATTTTCG	2	1
CATTCCACTATTACC	CATTCCACTATTACC	1	1
CCATGTATGAATCCG	CCATGTATGAATCCG	1	1
CCTTGGAATGCGTCT	CCTTGGAATGCGTCT	1	1
TGAGTGTGAAGGAAC	TGAGTGTGAAGGAAC	3	1
TGCCTAATCATATAT	TGCCTAATCATATAT	1	1
GGGCCTTGTTCTTTC	GGGCCTTGTTCTTTC	1	1
TTGTTAGGGTGTTCT	TTGTTAGGGTGTTCT	2	1
GGTTTTTATGATCAC	GGTTTTTATGATCAC	2	1
GTTCACCTCTCGCTG	GTTCACCTCTCGCTG	3	1
CCACGTCATATTATA	CCACGTCATATTATA	3	1
GCTAAAACCTCCATT	GCTAAAACCTCCATT	1	1
GAACGCCCTAAGGGG	GAACGCCCTAAGGGG	2	1
ATGTCCTATTTCGCA	ATGTCCTATTTCGCA	1	1
ACAGTCTTTTACAAT	ACAGTCTTTTACAAT	2	1
GCTGGGGACGCGTGG	GCTGGGGACGCGTGG	1	1
AACCACTGTCAGGGT	AACCACTGTCAGGGT	3	1
ACTATCTTCTTTTAG	ACTATCTTCTTTTAG	1	1
TGTTCGCATGTTAGG	TGTTCGCATGTTAGG	4	1
GCCTATACTCTATTA	GCCTATACTCTATTA	3	1
GTCTTGCCGACTTAT	GTCTTGCCGACTTAT	1	1
CGCTTCAGAATTCAT	CGCTTCAGAATTCAT	2	1
TTAAGAACCCCTTCA	TTAAGAACCCCTTCA	1	1
CTATTATTGGATTTC	CTATTATTGGATTTC	1	1
CTTCGAGTCCATAGT	CTTCGAGTCCATAGT	1	1
GGATGTACTCATTTG	GGATGTACTCATTTG	2	1
TGATAGTATGTGGAA	TGATAGTATGTGGAA	1	1
ATTACTGGCGATAAC	ATTACTGGCGATAAC	3	1
ACTTCAATCTTTTTA	ACTTCAATCTTTTTA	1	1
CATGCAGGGTGATCT	CATGCAGGGTGATCT	1	1
TGGCCATAGACCTCA	TGGCCATAGACCTCA	1	1
TAACACTACTTAAGT	TAACACTACTTAAGT	6	1
CCAGTTGCCGCGTAA	CCAGTTGCCGCGTAA	2	1
TTAGTCATGGACTAT	TTAGTCATGGACTAT	1	1
ATGTTAACAAACTAC	ATGTTAACAAACTAC	1	1
TCGTCGTTTCTCTTC	TCGTCGTTTCTCTTC	1	1
GTAAAAGCTGTTTAG	GTAAAAGCTGTTTAG	2	1
CTATACTTTGTTTCT	CTATACTTTGTTTCT	1	1
GAATATATTTAGAGC	GAATATATTTAGAGC	1	1
TGAGTCCCACACGTA	TGAGTCCCACACGTA	3	1
TTAACATTTTAAAAA	TTAACATTTTAAAAA	1	1
TGCCTATGTACACAA	TGCCTATGTACACAA	1	1
TATCTCACCCGAACG	TATCTCACCCGAACG	1	1
CGACGTGCGCGGGCG	CGACGTGCGCGGGCG	1	1
CTATAAAGGTATTTC	CTATAAAGGTATTTC	4	1
TCTAGGTTTGGGTTT	TCTAGGTTTGGGTTT	6	1
ATCTCATAATGTGGC	ATCTCATAATGTGGC	1	1
GGAGTGGGGGAAGGA	GGAGTGGGGGAAGGA	1	1
TTAACAAAAGTTCTA	TTAACAAAAGTTCTA	1	1
ATATATTAACGGAGT	ATATATTAACGGAGT	3	1
TGATGCATGGTCCTT	TGATGCATGGTCCTT	1	1
ATTGTATAGCCATAT	ATTGTATAGCCATAT	1	1
AGCAAGAAATTCTAA	AGCAAGAAATTCTAA	2	1
ATTTAGCCGTTTTGG	ATTTAGCCGTTTTGG	1	1
GCTGTCTGTCTCGTC	GCTGTCTGTCTCGTC	2	1
TATCTACGGCCTTTA	TATCTACGGCCTTTA	3	1
GATTTAACGGACTGT	GATTTAACGGACTGT	2	1
TGACGAACTCTGGGG	TGACGAACTCTGGGG	1	1
ATATACAGATATTTT	ATATACAGATATTTT	1	1
TTATTTACATATTGT	TTATTTACATATTGT	1	1
TCAGGGGAGACCTTA	TCAGGGGAGACCTTA	1	1
TCAAGATGTAATTGT	TCAAGATGTAATTGT	1	1
TCCGGTGTTGGCGCG	TCCGGTGTTGGCGCG	1	1
GCGTAAGCTTGCGAA	GCGTAAGCTTGCGAA	1	1
AGATGATCCCAACAC	AGATGATCCCAACAC	2	1
TCCATTCAAGGCGTT	TCCATTCAAGGCGTT	1	1
GGCGAATATCCAGAT	GGCGAATATCCAGAT	2	1
ATATATACGGGATAC	ATATATACGGGATAC	3	1
TTATCTTTAAAATTT	TTATCTTTAAAATTT	2	1
CCGGGTGGCGTGATT	CCGGGTGGCGTGATT	1	1
TTGATCCTTTTTCTC	TTGATCCTTTTTCTC	1	1
TAATCATTGCTTTTG	TAATCATTGCTTTTG	1	1
TAGTGCTATATAGTA	TAGTGCTATATAGTA	1	1
CGGTATGTCCGTCTT	CGGTATGTCCGTCTT	1	1
AGCCATATTAGCTAT	AGCCATATTAGCTAT	1	1
TCTTGTAAATACCTC	TCTTGTAAATACCTC	1	1
TATCGTAGTATTGGA	TATCGTAGTATTGGA	1	1
TTCCACTAGTCGGGT	TTCCACTAGTCGGGT	1	1
TTTCACCCACTTATC	TTTCACCCACTTATC	1	1
CGAACGTGAGTACAT	CGAACGTGAGTACAT	1	1
TTACCACGCTTTAAA	TTACCACGCTTTAAA	1	1
ACGATTGCCAACGCT	ACGATTGCCAACGCT	1	1
TTCTATATCTTCACT	TTCTATATCTTCACT	1	1
CTTCAACCTGAGTGG	CTTCAACCTGAGTGG	1	1
TAAAGGGTAGATACT	TAAAGGGTAGATACT	1	1
CGATTTGAGATGTTT	CGATTTGAGATGTTT	2	1
TTCATAGGTGAGAAA	TTCATAGGTGAGAAA	2	1
TATGTGCACTTGAAG	TATGTGCACTTGAAG	2	1
CTAGACCGATTATAA	CTAGACCGATTATAA	1	1
GCGTAATTTACTCGA	GCGTAATTTACTCGA	1	1
CCTTTCGTTTGTAAG	CCTTTCGTTTGTAAG	1	1
ACTAGGTGTAACCAT	ACTAGGTGTAACCAT	3	1
CATAGGCTGGCTCTA	CATAGGCTGGCTCTA	1	1
TACAGGCATTTCTAT	TACAGGCATTTCTAT	1	1
CCACTTAGTCTTGCA	CCACTTAGTCTTGCA	1	1
GTATTCTTGCCATTA	GTATTCTTGCCATTA	1	1
TGAGGGATTCCTCAT	TGAGGGATTCCTCAT	3	1
TGGGTTAGAACCCTC	TGGGTTAGAACCCTC	3	1
GGATACCTATATTAT	GGATACCTATATTAT	2	1
TTGTTGTGCCTATGT	TTGTTGTGCCTATGT	2	1
TCGTGACGTGTCGGC	TCGTGACGTGTCGGC	1	1
TCTCCAACAATTCTA	TCTCCAACAATTCTA	2	1
GATAGTGGAATTATG	GATAGTGGAATTATG	1	1
AACATACAACCCCTT	AACATACAACCCCTT	2	1
TCCCGATCTTCACTC	TCCCGATCTTCACTC	1	1
GTGACGGTGTCTCAA	GTGACGGTGTCTCAA	1	1
AAGTGCATAAACATT	AAGTGCATAAACATT	3	1
GGTTTTACTCGAATT	GGTTTTACTCGAATT	2	1
TTCGCAACCTTGGCT	TTCGCAACCTTGGCT	1	1
TGTTTTTGCGTCAGT	TGTTTTTGCGTCAGT	4	1
AGTTAATAGTACGAT	AGTTAATAGTACGAT	1	1
GTCTGATTCACGTTT	GTCTGATTCACGTTT	1	1
GGCGGGTGGGGTGGG	GGCGGGTGGGGTGGG	2	1
CGAGTTTGGAAGTCT	CGAGTTTGGAAGTCT	1	1
CTACTTAGTTAGGGT	CTACTTAGTTAGGGT	2	1
GCATTTTGTTAGTAG	GCATTTTGTTAGTAG	1	1
GGTGTAGGAGACACG	GGTGTAGGAGACACG	2	1
AATATATGGACCTTA	AATATATGGACCTTA	1	1
TAAATTCGGAGTTAT	TAAATTCGGAGTTAT	2	1
GAATGTACATCTGTT	GAATGTACATCTGTT	1	1
TTGTTTCGACACGTC	TTGTTTCGACACGTC	3	1
TTTACATAGATAGGT	TTTACATAGATAGGT	1	1
TTCTCCGGTCTGCAT	TTCTCCGGTCTGCAT	1	1
CGTGCATGCATGACT	CGTGCATGCATGACT	1	1
GTATTCAAAATGTCT	GTATTCAAAATGTCT	1	1
CGTAGGTATAATTCA	CGTAGGTATAATTCA	1	1
GGTGACCTGGTGGCA	GGTGACCTGGTGGCA	1	1
GTTGGACAGATCTCG	GTTGGACAGATCTCG	3	1
ATATTTTACTGTAGT	ATATTTTACTGTAGT	2	1
AGACCATGGTGGGAG	AGACCATGGTGGGAG	2	1
CCACTGAAATCACCA	CCACTGAAATCACCA	1	1
CACTTTGACGTTCAA	CACTTTGACGTTCAA	1	1
CGCTGAAACGATAAA	CGCTGAAACGATAAA	1	1
GGCTGGGGGGAACTT	GGCTGGGGGGAACTT	1	1
CGACTTCGCTTTTTT	CGACTTCGCTTTTTT	5	1
TGTAGCTTCTTGTCT	TGTAGCTTCTTGTCT	3	1
TCCAGCCATTCAATC	TCCAGCCATTCAATC	5	1
TGCGCTCAAACTATG	TGCGCTCAAACTATG	1	1
CAAGGATTATTTCAC	CAAGGATTATTTCAC	1	1
CAACTGGAACGCAAC	CAACTGGAACGCAAC	2	1
GAACTCGATGGTTAG	GAACTCGATGGTTAG	3	1
CCGCTGGTGACGCTT	CCGCTGGTGACGCTT	3	1
ATGCAGCCAAGAATG	ATGCAGCCAAGAATG	3	1
GTCTCGCCTGAGTAA	GTCTCGCCTGAGTAA	1	1
GTAGGCCTCTGCTTT	GTAGGCCTCTGCTTT	1	1
GCGGGCTGGGTAAGC	GCGGGCTGGGTAAGC	1	1
AGACGTTGAATATGC	AGACGTTGAATATGC	6	1
GAGGATAGGCTTTCG	GAGGATAGGCTTTCG	1	1
AAAGGTTAGGCTGGG	AAAGGTTAGGCTGGG	1	1
TTAAGCTGCGGCGTG	TTAAGCTGCGGCGTG	1	1
TTTTGGTTCAAGGTC	TTTTGGTTCAAGGTC	1	1
TAAAATTCTAAACAT	TAAAATTCTAAACAT	1	1
ACGTTATGCTATATT	ACGTTATGCTATATT	2	1
CCCTCCCGGCATCAC	CCCTCCCGGCATCAC	12	1
ATGTAAGCTTTTCCG	ATGTAAGCTTTTCCG	6	1
ACATTCCCATTGAAT	ACATTCCCATTGAAT	2	1
TGTTATCGCTTATAC	TGTTATCGCTTATAC	3	1
TCAGTTAGCGACGTT	TCAGTTAGCGACGTT	3	1
CGTGTTTGACTGATT	CGTGTTTGACTGATT	1	1
TGTGATAGTACGATA	TGTGATAGTACGATA	6	1
ACTTCGATAAAATAT	ACTTCGATAAAATAT	1	1
TCAGGCTCGATACGT	TCAGGCTCGATACGT	1	1
TAAGTTGAAAAGTAT	TAAGTTGAAAAGTAT	3	1
CCGGTTATTCGTACT	CCGGTTATTCGTACT	2	1
AAGCAAGTCATTGTA	AAGCAAGTCATTGTA	3	1
TTAGTCGTGTAGCGT	TTAGTCGTGTAGCGT	3	1
ATTCATAAGTGGTGA	ATTCATAAGTGGTGA	2	1
TGGGCGGTAGAAGGC	TGGGCGGTAGAAGGC	4	1
GGTAGAGTAAGTACA	GGTAGAGTAAGTACA	1	1
TATGACGACAGGGTG	TATGACGACAGGGTG	1	1
AAGTCCATGGGCCGG	AAGTCCATGGGCCGG	1	1
ATTAAAAAGCATATT	ATTAAAAAGCATATT	3	1
GAAACACGATTTTAT	GAAACACGATTTTAT	1	1
AGAGTCTCTAGAGGT	AGAGTCTCTAGAGGT	1	1
TTTCGCAATTGAAGT	TTTCGCAATTGAAGT	3	1
TATTCTTTATAAGTT	TATTCTTTATAAGTT	2	1
AATCACGTCGCATGG	AATCACGTCGCATGG	1	1
ACAGTACCTTTTCTC	ACAGTACCTTTTCTC	1	1
ATCTATTTGCCGTGG	ATCTATTTGCCGTGG	1	1
TTTCTAATGATTCAG	TTTCTAATGATTCAG	1	1
ATGGTACCATTGGGG	ATGGTACCATTGGGG	1	1
TAGGGCTTAACTTGT	TAGGGCTTAACTTGT	1	1
ATATTATAGGATCTA	ATATTATAGGATCTA	2	1
CACCGTGTGAAGGTA	CACCGTGTGAAGGTA	1	1
TAATGTTGATTCACT	TAATGTTGATTCACT	1	1
GTGCCGCCAAGTGGG	GTGCCGCCAAGTGGG	1	1
ACTGTAGCTATTGAC	ACTGTAGCTATTGAC	1	1
TCTTGAGTGTTCATG	TCTTGAGTGTTCATG	7	1
AGTCTGTACCTACGA	AGTCTGTACCTACGA	5	1
CCATGATCAGTCTAT	CCATGATCAGTCTAT	1	1
GTTTGTATTTTTTCA	GTTTGTATTTTTTCA	1	1
AAATCATCCTTACTT	AAATCATCCTTACTT	2	1
TTGCTCCTTTTATGT	TTGCTCCTTTTATGT	1	1
ATTACGAGTTTTAGC	ATTACGAGTTTTAGC	2	1
GTACTCTGCTGACTT	GTACTCTGCTGACTT	1	1
GGCTGAGGAAGGGGG	GGCTGAGGAAGGGGG	1	1
ATTTTGCGGTCTATT	ATTTTGCGGTCTATT	1	1
AAACAATATAATTTA	AAACAATATAATTTA	2	1
GAGCTCACTTTGCAA	GAGCTCACTTTGCAA	2	1
CATTATCAGAATGCC	CATTATCAGAATGCC	1	1
CTAAAAGGGGTTGGG	CTAAAAGGGGTTGGG	1	1
TTTTGACCTTGTATA	TTTTGACCTTGTATA	1	1
GCACTGTCACTAAGA	GCACTGTCACTAAGA	1	1
GGGGATGTGGTAATT	GGGGATGTGGTAATT	1	1
CGACCATATCGTATT	CGACCATATCGTATT	1	1
GTTTATTGTCCCTGA	GTTTATTGTCCCTGA	2	1
ATCCTTTTAAATTGC	ATCCTTTTAAATTGC	1	1
TACTGCGATCATCCA	TACTGCGATCATCCA	2	1
CGCATAAGCTTTTTC	CGCATAAGCTTTTTC	1	1
TGTTTCCTCGTTTCA	TGTTTCCTCGTTTCA	1	1
GATGCTATTTTTTCG	GATGCTATTTTTTCG	1	1
TCGCGAGTCTCTGTA	TCGCGAGTCTCTGTA	1	1
TAAAAATCTTCCATC	TAAAAATCTTCCATC	1	1
TTGATACACACTCGA	TTGATACACACTCGA	2	1
GTCCACATTTTATTA	GTCCACATTTTATTA	1	1
AAATAAGCACTTGAC	AAATAAGCACTTGAC	2	1
GGGTGATAGAACTAC	GGGTGATAGAACTAC	1	1
AAAATCCGTCCGTTT	AAAATCCGTCCGTTT	3	1
GATCTGACGGTCTAA	GATCTGACGGTCTAA	1	1
GCTTTAGTGTAGTTT	GCTTTAGTGTAGTTT	6	1
CCCTGGCGGTCCAGA	CCCTGGCGGTCCAGA	3	1
ACCAGCATCGTAACT	ACCAGCATCGTAACT	5	1
CGTGTATGACTCTTG	CGTGTATGACTCTTG	2	1
ATATTAAGAGATTTT	ATATTAAGAGATTTT	3	1
AAGAGTGATAAGAGC	AAGAGTGATAAGAGC	2	1
GGAAATGGTAGCTTC	GGAAATGGTAGCTTC	2	1
AGAGCTAATTCGAAA	AGAGCTAATTCGAAA	1	1
TACTATGCTACTGCT	TACTATGCTACTGCT	1	1
TCACATATTCGTTAC	TCACATATTCGTTAC	1	1
TACGCTGGAGCTTGA	TACGCTGGAGCTTGA	2	1
GAATCATTCGTATGA	GAATCATTCGTATGA	2	1
GGGACAGTCTTTCGG	GGGACAGTCTTTCGG	4	1
CATCTTCTGATGTTG	CATCTTCTGATGTTG	5	1
TTCAGTATATTTGCT	TTCAGTATATTTGCT	1	1
GTTAGGGAAATAATA	GTTAGGGAAATAATA	1	1
CATTGCTTAGCTCTC	CATTGCTTAGCTCTC	1	1
TGTAAAGTTTCCTCC	TGTAAAGTTTCCTCC	1	1
CTCCGGATGGTAAAT	CTCCGGATGGTAAAT	3	1
GACCAAGTCAACTAC	GACCAAGTCAACTAC	1	1
ATTAGTTTATCTCTA	ATTAGTTTATCTCTA	2	1
GGAAGCGGCGGTGGG	GGAAGCGGCGGTGGG	1	1
TTTGCATGCGAGAGT	TTTGCATGCGAGAGT	2	1
TGTAATATTCCAATT	TGTAATATTCCAATT	1	1
TTTTGGAAACTTTTT	TTTTGGAAACTTTTT	1	1
CACTAACCCAGCGCG	CACTAACCCAGCGCG	4	1
AGGTCCTTGGCATTA	AGGTCCTTGGCATTA	2	1
GTTCCCACGCGTGAG	GTTCCCACGCGTGAG	1	1
ATCACAAATAGCTTT	ATCACAAATAGCTTT	1	1
TGTCCGGTGGTGGGA	TGTCCGGTGGTGGGA	1	1
TACGGGGGGTGTTCT	TACGGGGGGTGTTCT	1	1
TAGGTTTGCAACAAT	TAGGTTTGCAACAAT	2	1
AACCGTGCTTCAACT	AACCGTGCTTCAACT	2	1
TAAGGCAATTAATTG	TAAGGCAATTAATTG	1	1
ATCGTTGTGATGGGG	ATCGTTGTGATGGGG	1	1
GTCGAGTTGGTGGGC	GTCGAGTTGGTGGGC	3	1
ATGGAGATGACGGAA	ATGGAGATGACGGAA	2	1
GGTGCAGTTTTTAGG	GGTGCAGTTTTTAGG	1	1
CCATTTTTAAGCCTA	CCATTTTTAAGCCTA	2	1
TATTAATGTCCATAC	TATTAATGTCCATAC	1	1
TCTTGGCTATGCTGT	TCTTGGCTATGCTGT	1	1
GCCTCACTGTACACA	GCCTCACTGTACACA	1	1
CAAGTTGGCTTAAGA	CAAGTTGGCTTAAGA	5	1
TCAGTTATCGACGTT	TCAGTTATCGACGTT	1	1
TATTGTAAGTTCCGT	TATTGTAAGTTCCGT	1	1
TTGAGTATAGAATCT	TTGAGTATAGAATCT	1	1
CGGACAACTCGTTTC	CGGACAACTCGTTTC	2	1
GGAGTAGGGGGCGTA	GGAGTAGGGGGCGTA	1	1
TCCCGTCTTGAGAAC	TCCCGTCTTGAGAAC	1	1
AGAGAACGAACACAA	AGAGAACGAACACAA	1	1
GCCTATGTTCGCTTT	GCCTATGTTCGCTTT	1	1
ATGCGTCACTTATTA	ATGCGTCACTTATTA	1	1
AGTCTGTCATAACTC	AGTCTGTCATAACTC	1	1
TCTATGTGGTTCAAG	TCTATGTGGTTCAAG	1	1
TGGACGGACGCAGTT	TGGACGGACGCAGTT	2	1
TTTATACTCATGCCT	TTTATACTCATGCCT	3	1
TATTTTCAAGAGTTG	TATTTTCAAGAGTTG	1	1
GTTTGGCACGACGAC	GTTTGGCACGACGAC	3	1
TTGCTATGTCAGCTG	TTGCTATGTCAGCTG	1	1
GAAGGGCGCATAGTG	GAAGGGCGCATAGTG	1	1
CGTGTACTCGGTGTA	CGTGTACTCGGTGTA	1	1
TTGTATGGAACAAAA	TTGTATGGAACAAAA	1	1
CATTTTCTGAAATTT	CATTTTCTGAAATTT	1	1
TGAACATGATCTTAA	TGAACATGATCTTAA	1	1
ATTCCGCTTTTCCAA	ATTCCGCTTTTCCAA	5	1
GCATCACTACTCTAT	GCATCACTACTCTAT	3	1
CGAAGGCCTACAATA	CGAAGGCCTACAATA	2	1
TAGTCTGTATCAATC	TAGTCTGTATCAATC	1	1
CGCGGGGTATATAAG	CGCGGGGTATATAAG	4	1
TCATCATCGATTCGA	TCATCATCGATTCGA	1	1
ATTGTCAATGTGTCG	ATTGTCAATGTGTCG	4	1
TTGTTATCTCTTTCG	TTGTTATCTCTTTCG	1	1
CTAAATTTTGTTCCT	CTAAATTTTGTTCCT	1	1
GGTGGAATGTGAATG	GGTGGAATGTGAATG	3	1
GTTAGAGATCATGGA	GTTAGAGATCATGGA	1	1
ATTGACATATTAGGG	ATTGACATATTAGGG	1	1
GTTGCGTCAGACGTG	GTTGCGTCAGACGTG	1	1
CCTCTACAAGACATT	CCTCTACAAGACATT	1	1
ATTAGTGGATTCCCA	ATTAGTGGATTCCCA	4	1
TGCCGGATTTATCAT	TGCCGGATTTATCAT	4	1
CCTTACATTATCACC	CCTTACATTATCACC	1	1
AATGCGCGCAACGTT	AATGCGCGCAACGTT	2	1
ATTCCTCTTTACAAT	ATTCCTCTTTACAAT	1	1
GTTAGTGGGGCGCGT	GTTAGTGGGGCGCGT	2	1
CAAGCTTTGCTAAAC	CAAGCTTTGCTAAAC	1	1
GGTTCAGATGTTAAT	GGTTCAGATGTTAAT	4	1
ACTCTACAAAAGAGA	ACTCTACAAAAGAGA	1	1
TAGAGTCAGTGCGAG	TAGAGTCAGTGCGAG	1	1
GTAAGACTCATCTGG	GTAAGACTCATCTGG	1	1
GGTTCGGCGTCCGGT	GGTTCGGCGTCCGGT	4	1
TTCGAGCGTCAATCG	TTCGAGCGTCAATCG	1	1
TGAAAGATAGGCACT	TGAAAGATAGGCACT	1	1
AGCGGAGGGGAAGTT	AGCGGAGGGGAAGTT	3	1
TTATCGAAACCGTAT	TTATCGAAACCGTAT	3	1
CACGTCATAGAACCT	CACGTCATAGAACCT	6	1
GCAGACGTAGCTTTG	GCAGACGTAGCTTTG	2	1
GGCCGTCAAGAACGC	GGCCGTCAAGAACGC	1	1
TCGTATATGTTGTTA	TCGTATATGTTGTTA	1	1
ACTGAGGTCTTAATC	ACTGAGGTCTTAATC	1	1
GTAATAATCCACATC	GTAATAATCCACATC	2	1
TAGCGTAGATTCGGC	TAGCGTAGATTCGGC	1	1
GCTGCGTGTCCCGGG	GCTGCGTGTCCCGGG	2	1
AGAAACTTAAGATAC	AGAAACTTAAGATAC	3	1
GTCCTTACGTATGAC	GTCCTTACGTATGAC	1	1
AGCGTCAGAGTAATT	AGCGTCAGAGTAATT	2	1
AATGCTCTAAGGCTT	AATGCTCTAAGGCTT	2	1
CCTATGTCATGCTCG	CCTATGTCATGCTCG	1	1
TGAACATTGAGGGGA	TGAACATTGAGGGGA	3	1
CTTTTATACATGTCT	CTTTTATACATGTCT	2	1
AACAGGGTCCTCCTT	AACAGGGTCCTCCTT	1	1
CCAGTCGCTTGGTCA	CCAGTCGCTTGGTCA	1	1
TGCCTAAAATACTTT	TGCCTAAAATACTTT	1	1
ATTTCTTGAATGTGA	ATTTCTTGAATGTGA	1	1
ATACGTGAATTCGAA	ATACGTGAATTCGAA	1	1
ATCGTAGCTCTTTTT	ATCGTAGCTCTTTTT	1	1
TCCATTTTAAATTTC	TCCATTTTAAATTTC	4	1
TTAGTGCAGAGACGT	TTAGTGCAGAGACGT	2	1
GATTCAAGGTTTGTT	GATTCAAGGTTTGTT	2	1
TAGCGGGTCGGAGGG	TAGCGGGTCGGAGGG	1	1
ATGTTGAAACTATTA	ATGTTGAAACTATTA	2	1
GGTCGACGGTGGCGC	GGTCGACGGTGGCGC	7	1
AACCGACTCTTATTT	AACCGACTCTTATTT	3	1
ACATTGCCTGTAGTT	ACATTGCCTGTAGTT	1	1
TTCCTGTGTTGCTTT	TTCCTGTGTTGCTTT	1	1
ATATAACTCGGCTGT	ATATAACTCGGCTGT	2	1
CCCAAACTTTGATAT	CCCAAACTTTGATAT	1	1
GTTTGTCCACAGAAT	GTTTGTCCACAGAAT	1	1
GTAAACTATTTAGGT	GTAAACTATTTAGGT	2	1
AATAAAGGGAAGTTG	AATAAAGGGAAGTTG	3	1
ATTGGTTTTCACTGA	ATTGGTTTTCACTGA	2	1
GATGCCTCTGGGTCA	GATGCCTCTGGGTCA	1	1
GCAGCACGGGATCAA	GCAGCACGGGATCAA	1	1
TTCGCGGTAAACATT	TTCGCGGTAAACATT	1	1
GCGTATTCAAAGGTG	GCGTATTCAAAGGTG	1	1
GTTCACCATTCGAAG	GTTCACCATTCGAAG	2	1
GTTGGCCGGTGTAAC	GTTGGCCGGTGTAAC	1	1
TGATGAGATTACTAG	TGATGAGATTACTAG	1	1
ACCCGTTACTGTCTC	ACCCGTTACTGTCTC	1	1
TGCATCTCGCATGAA	TGCATCTCGCATGAA	2	1
GCCGTAAATGGCTGA	GCCGTAAATGGCTGA	3	1
GTAAGGCTTAGACAT	GTAAGGCTTAGACAT	3	1
GGGTGGGGAGTGTGA	GGGTGGGGAGTGTGA	1	1
TCCATGCTTCTCATT	TCCATGCTTCTCATT	2	1
GTAGCCTAGAAGGCT	GTAGCCTAGAAGGCT	3	1
TTCTACATATCGCCG	TTCTACATATCGCCG	2	1
GGGGCGAGGGTGGTG	GGGGCGAGGGTGGTG	2	1
GACATTTGCTCTTTT	GACATTTGCTCTTTT	4	1
TCCTTTGCGACTCTA	TCCTTTGCGACTCTA	2	1
CCTGCTCTAGATTGT	CCTGCTCTAGATTGT	1	1
CTATGGTATCTATAA	CTATGGTATCTATAA	1	1
ATTTTAAGGATGTCA	ATTTTAAGGATGTCA	1	1
GTATACCCGGGTCTG	GTATACCCGGGTCTG	1	1
TGTCGAGAGTCACGG	TGTCGAGAGTCACGG	1	1
GGCGGGGGTGCGCTA	GGCGGGGGTGCGCTA	1	1
TTTTCATTGTCCCCT	TTTTCATTGTCCCCT	1	1
GTCCGGTTCCTGGGA	GTCCGGTTCCTGGGA	1	1
ATCGCAATTTGACGT	ATCGCAATTTGACGT	2	1
TTGTGGCGCCATTTT	TTGTGGCGCCATTTT	1	1
AGCTTACTTTCCCCA	AGCTTACTTTCCCCA	1	1
ACAAAACGCCCTTGT	ACAAAACGCCCTTGT	2	1
GCGTGGGGCCAGGTC	GCGTGGGGCCAGGTC	4	1
TACTGTCTACTTATG	TACTGTCTACTTATG	3	1
TAATGCCGGCTGGAT	TAATGCCGGCTGGAT	1	1
GTATTTTTACTGACT	GTATTTTTACTGACT	4	1
ACAATTTGCTATCAT	ACAATTTGCTATCAT	1	1
TCTGTTTACCATTTG	TCTGTTTACCATTTG	1	1
TGATTACGAATTAAA	TGATTACGAATTAAA	1	1
TCGGCTGAGATAATG	TCGGCTGAGATAATG	3	1
TAACATCTCTGATAT	TAACATCTCTGATAT	1	1
AACGGTGACAAGTGG	AACGGTGACAAGTGG	2	1
TTGCCGTATGGAGTG	TTGCCGTATGGAGTG	1	1
CCCCAGTATATCTTA	CCCCAGTATATCTTA	1	1
TATCAGTTACCCATA	TATCAGTTACCCATA	3	1
TAGTACCGGGAGGAG	TAGTACCGGGAGGAG	1	1
ATTCTACACCTGGGT	ATTCTACACCTGGGT	1	1
GAGAGGAGCGAAAGG	GAGAGGAGCGAAAGG	1	1
TTTCGTCAAAATAAA	TTTCGTCAAAATAAA	1	1
GTGTCTAGTCTTTTG	GTGTCTAGTCTTTTG	1	1
TGTATGTGATATATC	TGTATGTGATATATC	1	1
GCGTGGCTTAGGTTG	GCGTGGCTTAGGTTG	1	1
GTTGCCGGGCGGGGG	GTTGCCGGGCGGGGG	1	1
TATAATGTGCTGCGT	TATAATGTGCTGCGT	1	1
TACGCCTTACTACGT	TACGCCTTACTACGT	2	1
TTAATGCCACTCTGT	TTAATGCCACTCTGT	2	1
GACATTATGGCATTC	GACATTATGGCATTC	2	1
AGTAGTGTGGTGTAA	AGTAGTGTGGTGTAA	2	1
AGCGAATTCAATGTG	AGCGAATTCAATGTG	1	1
GTTTACAGCTATCTA	GTTTACAGCTATCTA	3	1
AGACGGAGGGTCTAG	AGACGGAGGGTCTAG	1	1
TATGGCTGTCGAGTT	TATGGCTGTCGAGTT	2	1
CTAAACTAATATAAT	CTAAACTAATATAAT	1	1
GCGTGCAGGGGGCTG	GCGTGCAGGGGGCTG	2	1
GCAAATCCGTCTATT	GCAAATCCGTCTATT	1	1
TCTGGCGAATTTAGG	TCTGGCGAATTTAGG	1	1
TACAACTAGGAGTCT	TACAACTAGGAGTCT	2	1
CGGATCACGTAACCT	CGGATCACGTAACCT	1	1
TGTTGGTAGAGGAAG	TGTTGGTAGAGGAAG	1	1
ATAGGGATAATGCGG	ATAGGGATAATGCGG	1	1
TTGAAAATATAGTCT	TTGAAAATATAGTCT	2	1
TGCGGGCGAGTTGAG	TGCGGGCGAGTTGAG	1	1
GCGCGATATCGTCTT	GCGCGATATCGTCTT	1	1
AATTTCTTTACTCCT	AATTTCTTTACTCCT	2	1
ATTTGGGATATTGAC	ATTTGGGATATTGAC	6	1
TGCGGGTGTTATATA	TGCGGGTGTTATATA	2	1
CAATGGGGGAATTCC	CAATGGGGGAATTCC	4	1
GAGTCGGGCTGGAAA	GAGTCGGGCTGGAAA	2	1
GTTTATAACATACGA	GTTTATAACATACGA	2	1
AACAAAAGCAGTGGA	AACAAAAGCAGTGGA	1	1
AGATACTTGCATATG	AGATACTTGCATATG	1	1
TTAGATAATCTTACC	TTAGATAATCTTACC	2	1
ATGACGAGTACTCCT	ATGACGAGTACTCCT	2	1
GTTGACGGACTATTG	GTTGACGGACTATTG	2	1
TATGTTCGTGCTGTA	TATGTTCGTGCTGTA	1	1
AGAGCTTGAAATCAT	AGAGCTTGAAATCAT	1	1
TTGGTTTTATAGTGA	TTGGTTTTATAGTGA	2	1
TTATTGCTGTCTCAT	TTATTGCTGTCTCAT	1	1
TCGCAAGAGGAATTC	TCGCAAGAGGAATTC	1	1
TCGTTCAAAAATACT	TCGTTCAAAAATACT	1	1
GGGACAGTGGGTCTG	GGGACAGTGGGTCTG	1	1
GTCATGACAAAAGTA	GTCATGACAAAAGTA	1	1
TCATGGTGAGCGCCA	TCATGGTGAGCGCCA	1	1
TACCGTGCGGTAAGG	TACCGTGCGGTAAGG	1	1
GTTTGACCAATTGTA	GTTTGACCAATTGTA	1	1
TCTCCCGAGTTACAG	TCTCCCGAGTTACAG	1	1
TTTTTAATCGTTAGG	TTTTTAATCGTTAGG	1	1
ATAAATCCTTCTACA	ATAAATCCTTCTACA	6	1
CTGCGCAATTGGTTG	CTGCGCAATTGGTTG	1	1
ACGATTTACCAGGCT	ACGATTTACCAGGCT	2	1
GTGGTCTCTACTGTT	GTGGTCTCTACTGTT	1	1
GTTTCACTTTTGCTA	GTTTCACTTTTGCTA	1	1
ATCTTCCCGCTGGCT	ATCTTCCCGCTGGCT	1	1
GCATCTGAATGAGAT	GCATCTGAATGAGAT	1	1
CTTCTTTTCTCGAAG	CTTCTTTTCTCGAAG	2	1
GGGTTTAGATTATGG	GGGTTTAGATTATGG	1	1
ACCCATGTTCACACT	ACCCATGTTCACACT	1	1
TTTTTGAATCTATGT	TTTTTGAATCTATGT	1	1
GGCTGCCGGTTCATC	GGCTGCCGGTTCATC	1	1
GGACTTTTGCAGTGA	GGACTTTTGCAGTGA	1	1
GGATTTTTACATAAC	GGATTTTTACATAAC	1	1
GTCGGACTTACAATG	GTCGGACTTACAATG	1	1
GGAGCCCGTTTAATC	GGAGCCCGTTTAATC	1	1
GGTTAACAGCGGTGG	GGTTAACAGCGGTGG	1	1
TAGGATCAGCATGCG	TAGGATCAGCATGCG	3	1
ATTTAGCAAAATAGC	ATTTAGCAAAATAGC	1	1
ACAAATATGTTGTAC	ACAAATATGTTGTAC	1	1
GGTTATTTTTCGGTG	GGTTATTTTTCGGTG	2	1
TTGACAGTTCGGGTT	TTGACAGTTCGGGTT	4	1
CACATAATCTCCTGC	CACATAATCTCCTGC	1	1
TTCACAGCATCTCTA	TTCACAGCATCTCTA	1	1
AATTGTAATTTGTGT	AATTGTAATTTGTGT	1	1
ATTAAGTGCGTTACA	ATTAAGTGCGTTACA	1	1
GTTTTAATCTTTAAT	GTTTTAATCTTTAAT	1	1
TCCAATCAACGTGTT	TCCAATCAACGTGTT	1	1
TAATCTGTCGAGGAT	TAATCTGTCGAGGAT	1	1
AGCTGCCTCGTTGCC	AGCTGCCTCGTTGCC	2	1
TAAGATGCTCCCATT	TAAGATGCTCCCATT	1	1
TATCCGGTTGGGTCT	TATCCGGTTGGGTCT	2	1
TTATCTCACAACTTA	TTATCTCACAACTTA	1	1
CTCCTGCGGGGGGCG	CTCCTGCGGGGGGCG	2	1
GTAACTATTTATGAT	GTAACTATTTATGAT	1	1
ATACATTGGGTGTTG	ATACATTGGGTGTTG	3	1
TGCCAGGTAAGGAAA	TGCCAGGTAAGGAAA	1	1
GTAGGGCGGACGGCA	GTAGGGCGGACGGCA	2	1
GGTCTGCGTCAAGGC	GGTCTGCGTCAAGGC	2	1
ATGTGTGAGACATCG	ATGTGTGAGACATCG	1	1
AATCCTTGTCTCTGT	AATCCTTGTCTCTGT	1	1
CCTTATGTCTCCAGG	CCTTATGTCTCCAGG	1	1
TTATGTGAATTGCAC	TTATGTGAATTGCAC	3	1
GCTAATGTGTTCCAC	GCTAATGTGTTCCAC	1	1
AAATCTATATCAAGG	AAATCTATATCAAGG	2	1
ATATCTGATGCGTGG	ATATCTGATGCGTGG	1	1
GTCTCGTTGCCTTTC	GTCTCGTTGCCTTTC	5	1
ACGCGTCGGTGTTTA	ACGCGTCGGTGTTTA	1	1
GTATAGAAACTGAAT	GTATAGAAACTGAAT	2	1
GGAATGGAAGTCTGG	GGAATGGAAGTCTGG	1	1
AGCCACGGCCTTCCT	AGCCACGGCCTTCCT	1	1
ATCTTGAACGGATTC	ATCTTGAACGGATTC	2	1
GGCTCCCTAAAACTT	GGCTCCCTAAAACTT	2	1
AAATAATAGGTTCGT	AAATAATAGGTTCGT	3	1
AAAGCGCATTATTCA	AAAGCGCATTATTCA	3	1
AGCGTAACTACGTCG	AGCGTAACTACGTCG	2	1
GCTAAATTGAATATG	GCTAAATTGAATATG	1	1
ATAGGTGGGAAGTAA	ATAGGTGGGAAGTAA	3	1
CAAGGTTATCGATGT	CAAGGTTATCGATGT	1	1
TAGAGATTCGGTTCT	TAGAGATTCGGTTCT	1	1
ACGTTGAGACAATGT	ACGTTGAGACAATGT	1	1
CAAATTGGATTTAAT	CAAATTGGATTTAAT	1	1
CTGCAATAGACATTG	CTGCAATAGACATTG	1	1
TAAGCTTGCTTAACG	TAAGCTTGCTTAACG	2	1
TTTACTGTCGACTTT	TTTACTGTCGACTTT	1	1
TACATCTTCTTTTAT	TACATCTTCTTTTAT	1	1
GTCGCTAACAACACA	GTCGCTAACAACACA	1	1
ACGGTTCTGTTGCTC	ACGGTTCTGTTGCTC	1	1
AATGTCAGATATTCT	AATGTCAGATATTCT	3	1
TGCAAAAGTGCGCAA	TGCAAAAGTGCGCAA	1	1
GAAGACGTATGATTT	GAAGACGTATGATTT	1	1
TTTGAATTTTAATTA	TTTGAATTTTAATTA	1	1
TACATAACCCTTCTA	TACATAACCCTTCTA	1	1
CCCGGGTTTAATCGT	CCCGGGTTTAATCGT	1	1
GAAGTGAATAGGTAT	GAAGTGAATAGGTAT	1	1
TTGAAATTATTTCCA	TTGAAATTATTTCCA	1	1
CTCAGGCCGCATGGG	CTCAGGCCGCATGGG	2	1
AAATTCTGTTAGCAG	AAATTCTGTTAGCAG	2	1
GATAGTCCTTCACCT	GATAGTCCTTCACCT	1	1
TAATCTACGACCGTA	TAATCTACGACCGTA	1	1
CTCATTCGTGTAGGT	CTCATTCGTGTAGGT	3	1
ACCTCCATTCAAGAA	ACCTCCATTCAAGAA	2	1
ACTATCTTCTTTTAT	ACTATCTTCTTTTAT	1	1
TATCGTCCAATTGAT	TATCGTCCAATTGAT	1	1
GAATCTATTTTTGAT	GAATCTATTTTTGAT	2	1
ATCTCAAATCGCAGA	ATCTCAAATCGCAGA	3	1
CAATTCTTTATCCAT	CAATTCTTTATCCAT	2	1
GAAGAGGGTCGATTG	GAAGAGGGTCGATTG	1	1
TTCTAGCTTGGCTCG	TTCTAGCTTGGCTCG	1	1
CTGATTGTCACATTG	CTGATTGTCACATTG	1	1
TGCAACTTTTCTAAT	TGCAACTTTTCTAAT	1	1
AAATCTACGATAGGT	AAATCTACGATAGGT	1	1
GTTCGTTTGCAATAT	GTTCGTTTGCAATAT	5	1
TATTTCTTAACCCCT	TATTTCTTAACCCCT	1	1
TACTCATAGCTAAGG	TACTCATAGCTAAGG	1	1
TTCTTTGTCCTTTAT	TTCTTTGTCCTTTAT	1	1
ATGCGTTCTGCAACA	ATGCGTTCTGCAACA	3	1
CGTTTGGGGGGGGGG	CGTTTGGGGGGGGGG	2	1
TAGTATGTCATGTCG	TAGTATGTCATGTCG	3	1
AGACTGTGATTCTCC	AGACTGTGATTCTCC	1	1
CTGTGGCGACTTTCC	CTGTGGCGACTTTCC	2	1
ATAGTCTTCACAATG	ATAGTCTTCACAATG	2	1
ATACGTAAAGCTTGA	ATACGTAAAGCTTGA	1	1
TTGGGGATAATCGAT	TTGGGGATAATCGAT	1	1
TTTTTTCCGATTCTT	TTTTTTCCGATTCTT	2	1
CGCGGCAAGACGGGT	CGCGGCAAGACGGGT	1	1
TCATAGATGAGGTCG	TCATAGATGAGGTCG	1	1
AATTGCGGTTATCTC	AATTGCGGTTATCTC	1	1
TTGCTTGTAATGCGT	TTGCTTGTAATGCGT	1	1
TCGTAGCAAAAATTG	TCGTAGCAAAAATTG	2	1
AATTTTGTGCTGGTG	AATTTTGTGCTGGTG	1	1
ACTGCGCAAGGAGGT	ACTGCGCAAGGAGGT	1	1
GACATATGTTATATA	GACATATGTTATATA	1	1
TATAGAAAATTCATT	TATAGAAAATTCATT	1	1
CTATAAGGAATTGCA	CTATAAGGAATTGCA	1	1
GTCATTGTTTGGGTT	GTCATTGTTTGGGTT	1	1
TTATGAATAAGATCT	TTATGAATAAGATCT	1	1
GCAAAATATCGCTTA	GCAAAATATCGCTTA	2	1
TATGGTGAGTGGGCT	TATGGTGAGTGGGCT	1	1
CGTTTACATTATGAT	CGTTTACATTATGAT	1	1
TTTTAGGTTGTCTTC	TTTTAGGTTGTCTTC	1	1
CTTAGTTCGTCCCTG	CTTAGTTCGTCCCTG	2	1
GTGAGTAGGGGGTTG	GTGAGTAGGGGGTTG	2	1
GGCTTGGCGTCACGG	GGCTTGGCGTCACGG	2	1
GGTGGGAGTAATGGT	GGTGGGAGTAATGGT	2	1
CATTCCGTGAACCGG	CATTCCGTGAACCGG	1	1
TCTATAAGGCCGCTA	TCTATAAGGCCGCTA	1	1
GGCAGGGTTGTTGAA	GGCAGGGTTGTTGAA	1	1
CTTTGCAAGCATTCG	CTTTGCAAGCATTCG	2	1
GATTTCGGTCGGAAG	GATTTCGGTCGGAAG	1	1
GTTTGCTGTAATAAA	GTTTGCTGTAATAAA	2	1
CCGCATGCCTTCTTA	CCGCATGCCTTCTTA	1	1
AGGCACACTAGTATA	AGGCACACTAGTATA	2	1
TCTATTCCGACATCG	TCTATTCCGACATCG	1	1
CTTTACCAGGTGGAG	CTTTACCAGGTGGAG	2	1
GAACTTGCCAAATAC	GAACTTGCCAAATAC	2	1
ATCTTGTCACATTAA	ATCTTGTCACATTAA	2	1
TCTAGGTCCGCCCTA	TCTAGGTCCGCCCTA	1	1
ATCTAGTTTGCTAAT	ATCTAGTTTGCTAAT	1	1
TAATTAGTTTAATAT	TAATTAGTTTAATAT	1	1
TAAACCGAGAAATTG	TAAACCGAGAAATTG	2	1
ATATGTGTTCTATGT	ATATGTGTTCTATGT	3	1
TGAAGGAGTTGGTCT	TGAAGGAGTTGGTCT	1	1
TGATTATAGCAATCA	TGATTATAGCAATCA	1	1
GTCTACGTTGTAGCG	GTCTACGTTGTAGCG	1	1
GTCGATCCGTTGACC	GTCGATCCGTTGACC	1	1
ACATTTACTCCCCCC	ACATTTACTCCCCCC	1	1
GGGAGGTACACTCGG	GGGAGGTACACTCGG	1	1
GTGTTACGCGTTTTA	GTGTTACGCGTTTTA	1	1
AGCGTCAGTGTTTGT	AGCGTCAGTGTTTGT	2	1
CTGGAGACGACTACG	CTGGAGACGACTACG	2	1
ATGTCTCTCCTGAAA	ATGTCTCTCCTGAAA	1	1
GTCGTGTGGGTTTTG	GTCGTGTGGGTTTTG	1	1
TATATAGCACAAGTG	TATATAGCACAAGTG	1	1
TAAATAAACTGAATC	TAAATAAACTGAATC	3	1
AATCTTTTCAAGTGT	AATCTTTTCAAGTGT	1	1
TTCGCCCTTTCTCAA	TTCGCCCTTTCTCAA	1	1
TCTAGTATTAAGATT	TCTAGTATTAAGATT	1	1
GCGTGCGCTGCGTGG	GCGTGCGCTGCGTGG	3	1
TCTTGGGCTGCATGC	TCTTGGGCTGCATGC	1	1
TAAGATTATAGAAAG	TAAGATTATAGAAAG	1	1
GTTTCTATCTTGTCT	GTTTCTATCTTGTCT	1	1
TGCATTGCTACAGAT	TGCATTGCTACAGAT	1	1
CTTAGATTCATAGTC	CTTAGATTCATAGTC	6	1
AAATGGTCAATCAAT	AAATGGTCAATCAAT	16	1
TGTTGGGTTCGAGTT	TGTTGGGTTCGAGTT	4	1
GATAAGATTTCATCT	GATAAGATTTCATCT	2	1
GAACCTTTCTTTCCT	GAACCTTTCTTTCCT	1	1
TTTATGTGGTGACTC	TTTATGTGGTGACTC	1	1
CATCATATCCAGTTA	CATCATATCCAGTTA	1	1
TAGGCGTTGCGAAGT	TAGGCGTTGCGAAGT	1	1
TTGTAGCCTGTCTAG	TTGTAGCCTGTCTAG	1	1
GTAGAAGGTTAAATG	GTAGAAGGTTAAATG	1	1
TAATTTCGAGCTTGT	TAATTTCGAGCTTGT	1	1
AACATCTTCAATAAC	AACATCTTCAATAAC	1	1
GCGGCAATGTTGGGA	GCGGCAATGTTGGGA	2	1
GTAAATGGTCTGCTT	GTAAATGGTCTGCTT	1	1
TCATCAGCACTTCTT	TCATCAGCACTTCTT	1	1
TCAGAGCTTTTCAGG	TCAGAGCTTTTCAGG	3	1
ATTTAGCACTGTAAT	ATTTAGCACTGTAAT	1	1
AGACGAAAGTAGATT	AGACGAAAGTAGATT	2	1
ACTTTATTAGGGCTG	ACTTTATTAGGGCTG	1	1
GTACATTGTTGTATC	GTACATTGTTGTATC	1	1
TGCTTAGGATTTGTT	TGCTTAGGATTTGTT	2	1
CATACAACAATGTCC	CATACAACAATGTCC	2	1
ACAGCTTGGTCGGAG	ACAGCTTGGTCGGAG	1	1
AAAGTCGGCTGTTAA	AAAGTCGGCTGTTAA	1	1
CGCGTCAAGTCAGCT	CGCGTCAAGTCAGCT	1	1
TCAGGCTTGTCGAGT	TCAGGCTTGTCGAGT	2	1
AGTTATCCTGGAAGA	AGTTATCCTGGAAGA	1	1
GTAGCGCCAATTGTA	GTAGCGCCAATTGTA	1	1
CCATGGAAATGCGTA	CCATGGAAATGCGTA	1	1
CCAAGGAGCTTACTA	CCAAGGAGCTTACTA	2	1
GGAAAAGGATGCTTA	GGAAAAGGATGCTTA	1	1
TGCGCTCCGATATTT	TGCGCTCCGATATTT	1	1
TGATAGTCCGTCAAT	TGATAGTCCGTCAAT	1	1
TCTGGAGGGAGTGTG	TCTGGAGGGAGTGTG	2	1
AACGGAGGCGGTCGT	AACGGAGGCGGTCGT	2	1
AATAATATATTCTGA	AATAATATATTCTGA	1	1
ATGATGATAAAAGCG	ATGATGATAAAAGCG	1	1
AACGTGTCATGTAAC	AACGTGTCATGTAAC	2	1
CCGAACGTTGACACG	CCGAACGTTGACACG	1	1
AATTGGGGCTAGACA	AATTGGGGCTAGACA	1	1
CGGACGGTGTGTTTC	CGGACGGTGTGTTTC	1	1
TTTCAAACAGGATGC	TTTCAAACAGGATGC	1	1
AATGGGCGAGGTTTT	AATGGGCGAGGTTTT	2	1
CAATGTTGAATAGAG	CAATGTTGAATAGAG	1	1
GTTCCAACACATCAT	GTTCCAACACATCAT	1	1
TAACGTATGTAATGT	TAACGTATGTAATGT	2	1
GTCTGCGGGGAGGCC	GTCTGCGGGGAGGCC	1	1
TTAGAAGACTATTTG	TTAGAAGACTATTTG	2	1
CACCAGAAGAGACGT	CACCAGAAGAGACGT	3	1
GTGGCAAGTATTGGT	GTGGCAAGTATTGGT	2	1
TAAGGCGTATTGGGA	TAAGGCGTATTGGGA	4	1
GAATACGCTTAAGTA	GAATACGCTTAAGTA	2	1
TCTTATGTTGGAAAT	TCTTATGTTGGAAAT	1	1
TGTGCGATTGGCGGT	TGTGCGATTGGCGGT	1	1
TTTGCCTTTCGATTT	TTTGCCTTTCGATTT	2	1
TTACACGGTGGTTTT	TTACACGGTGGTTTT	1	1
GTACTATCTTCGGGG	GTACTATCTTCGGGG	1	1
TTACAATGTTATCTG	TTACAATGTTATCTG	1	1
TCATACGCTCGCTAC	TCATACGCTCGCTAC	1	1
CGCACATTGTCTCGG	CGCACATTGTCTCGG	2	1
GTCACCGAAAAACGA	GTCACCGAAAAACGA	1	1
TAACTGAAACCCATG	TAACTGAAACCCATG	2	1
ACGGCGTCACCAATA	ACGGCGTCACCAATA	2	1
CGCCTTCCCTACGCA	CGCCTTCCCTACGCA	1	1
ATCTACATACACTGT	ATCTACATACACTGT	2	1
ATTGGTTAAGTATTA	ATTGGTTAAGTATTA	1	1
AGAAATGAAGGGGCG	AGAAATGAAGGGGCG	1	1
CGACAGTCGTATCCA	CGACAGTCGTATCCA	2	1
TCCCTCTTTGGCGTG	TCCCTCTTTGGCGTG	1	1
CCTAGATCTCAGGGT	CCTAGATCTCAGGGT	2	1
AAGCAAAGGAACGTC	AAGCAAAGGAACGTC	2	1
AGTCGAGTCAATTAG	AGTCGAGTCAATTAG	1	1
ACGTACCGCTCCGCG	ACGTACCGCTCCGCG	1	1
CTATTGCCTCCTGGG	CTATTGCCTCCTGGG	1	1
AAAAGACTGCCGATA	AAAAGACTGCCGATA	2	1
ACCATCATTTAAGTT	ACCATCATTTAAGTT	1	1
CACTTCTTTTTACCG	CACTTCTTTTTACCG	1	1
CCAGGCCATGACCGA	CCAGGCCATGACCGA	1	1
CTTTTAGAAGTGCCT	CTTTTAGAAGTGCCT	2	1
AAATGAGATGGAGAA	AAATGAGATGGAGAA	1	1
TCCAATTGGATAATA	TCCAATTGGATAATA	2	1
TTATGTACAATGGAG	TTATGTACAATGGAG	1	1
TGATGCCCATTTTTG	TGATGCCCATTTTTG	1	1
GGTGCGGCGGAGTGA	GGTGCGGCGGAGTGA	2	1
GGCACGATCGAAATG	GGCACGATCGAAATG	4	1
ATCGAATTGCTGAAC	ATCGAATTGCTGAAC	1	1
AACGTTGTCTCGGTT	AACGTTGTCTCGGTT	2	1
ACGAGGTACTTTTTG	ACGAGGTACTTTTTG	4	1
GTCTTTGTTGTTTCA	GTCTTTGTTGTTTCA	1	1
GCATGAAGATTCTAT	GCATGAAGATTCTAT	1	1
GGGGTGCGAGCGAGG	GGGGTGCGAGCGAGG	1	1
TACTTAGCACATTAC	TACTTAGCACATTAC	1	1
GATTCAAGGCAGATC	GATTCAAGGCAGATC	1	1
GCGTAAAATCGTCGG	GCGTAAAATCGTCGG	1	1
GATCGTGTTTTGAAC	GATCGTGTTTTGAAC	1	1
ATCTGGTGACAAGGG	ATCTGGTGACAAGGG	2	1
ATCCCCTTTTGATTT	ATCCCCTTTTGATTT	1	1
ACTAACATGTTTTGA	ACTAACATGTTTTGA	1	1
TGTTTTCGGTGCACA	TGTTTTCGGTGCACA	1	1
TATTTCCCATCTTGT	TATTTCCCATCTTGT	1	1
TTATGTAGTAGAGGT	TTATGTAGTAGAGGT	1	1
TGTTGAAAGATATCG	TGTTGAAAGATATCG	1	1
TAAGTACATACGGTA	TAAGTACATACGGTA	2	1
CTCTTCAATATCAAT	CTCTTCAATATCAAT	3	1
TTTGCTAATATTCTA	TTTGCTAATATTCTA	1	1
ATAGGCGTGAGGCAA	ATAGGCGTGAGGCAA	1	1
ACTCGTACCCATGAT	ACTCGTACCCATGAT	1	1
AGTAACTGCCTAAGG	AGTAACTGCCTAAGG	1	1
CTTCAATGCATTCAA	CTTCAATGCATTCAA	1	1
CGGTTGAAACTCCGT	CGGTTGAAACTCCGT	2	1
TGGTGGTGCTGTGTT	TGGTGGTGCTGTGTT	1	1
TGGTTGTCGAATGGT	TGGTTGTCGAATGGT	5	1
AGTAATTGTGGGGTA	AGTAATTGTGGGGTA	1	1
CGGATGTTACGGTTC	CGGATGTTACGGTTC	2	1
ATGACCACTCGAATT	ATGACCACTCGAATT	1	1
AGAAGCGTCGAGCTT	AGAAGCGTCGAGCTT	2	1
TGCTGGCAGGTTTTA	TGCTGGCAGGTTTTA	2	1
ACTAATCCTTGCTAT	ACTAATCCTTGCTAT	2	1
TATGTTGATCTTATA	TATGTTGATCTTATA	2	1
TCTACTTTCTAATAT	TCTACTTTCTAATAT	2	1
ATTTGGTTCTTTTAG	ATTTGGTTCTTTTAG	3	1
TAGCATTTTGATTGC	TAGCATTTTGATTGC	1	1
AATGCTATTCACCGT	AATGCTATTCACCGT	1	1
AAGTTCGTCCTTATC	AAGTTCGTCCTTATC	1	1
TTTCTGAACGTTGAA	TTTCTGAACGTTGAA	3	1
CGTTCGACTGGAGTA	CGTTCGACTGGAGTA	1	1
TTTCTGTGCGCCTTG	TTTCTGTGCGCCTTG	5	1
TGAGTACCTTTTCAT	TGAGTACCTTTTCAT	1	1
AATTTAGGGTGTCGT	AATTTAGGGTGTCGT	3	1
GTATTACTATTTTAA	GTATTACTATTTTAA	1	1
GGGCGGGGGGCGATG	GGGCGGGGGGCGATG	1	1
AAGTATCGCGGTGGA	AAGTATCGCGGTGGA	1	1
TGAGACATCCGTCCT	TGAGACATCCGTCCT	1	1
TAAACGGCCAATACT	TAAACGGCCAATACT	2	1
GTTTGTCTTGATTTC	GTTTGTCTTGATTTC	1	1
GCGGTATAGCCGTCT	GCGGTATAGCCGTCT	1	1
TAGGTGATTTAGTTG	TAGGTGATTTAGTTG	1	1
TCTATTATTTCACAT	TCTATTATTTCACAT	1	1
TCTCTCATCAATATA	TCTCTCATCAATATA	1	1
TAATTCTCTCGATAA	TAATTCTCTCGATAA	1	1
ACTTATGATTTTAGC	ACTTATGATTTTAGC	1	1
GCTGCACGGATCGAC	GCTGCACGGATCGAC	1	1
CTCACTCAGCCTCCA	CTCACTCAGCCTCCA	1	1
TTGCCCAACCGGAGG	TTGCCCAACCGGAGG	1	1
TATTGTGTGACTCAG	TATTGTGTGACTCAG	3	1
GGCCAGGCTATATTC	GGCCAGGCTATATTC	1	1
CTTCGGTTTGCTTGG	CTTCGGTTTGCTTGG	1	1
GTGCGAGCAGGTCAG	GTGCGAGCAGGTCAG	1	1
GTATGTATTGTGGAT	GTATGTATTGTGGAT	1	1
GGGCGGCGGCGGCGG	GGGCGGCGGCGGCGG	1	1
ACCATGTGATACGCG	ACCATGTGATACGCG	3	1
GGCTGTGATCTCATT	GGCTGTGATCTCATT	1	1
CCCCCTGCTTATCCA	CCCCCTGCTTATCCA	1	1
TGAAGTTGGGGCAGA	TGAAGTTGGGGCAGA	2	1
TTACCACTCGAACGA	TTACCACTCGAACGA	2	1
GCTTCTGTCATAATA	GCTTCTGTCATAATA	1	1
GGTAAATTGACTGTT	GGTAAATTGACTGTT	3	1
CTCGGGCCCGGTCGT	CTCGGGCCCGGTCGT	3	1
GCAAGCTATAAGGCT	GCAAGCTATAAGGCT	2	1
AAGTTTGCTATGTCT	AAGTTTGCTATGTCT	1	1
AACGGGAAACAACTC	AACGGGAAACAACTC	1	1
TGGTCGGTTGATCGA	TGGTCGGTTGATCGA	1	1
GTACGACATCAGTAA	GTACGACATCAGTAA	1	1
GGTATAGTAAGCGAT	GGTATAGTAAGCGAT	1	1
CATAGCCATGATTAC	CATAGCCATGATTAC	1	1
TTCTCATTGGTTCAC	TTCTCATTGGTTCAC	1	1
TGGTGGCTCATTAGG	TGGTGGCTCATTAGG	1	1
TTTGGATCATATATA	TTTGGATCATATATA	2	1
GCGTGCGCGTATGGT	GCGTGCGCGTATGGT	1	1
TAAACCACAACTAGG	TAAACCACAACTAGG	1	1
GTCAGCTATCTGAGG	GTCAGCTATCTGAGG	1	1
GATCATAGGTGGTTG	GATCATAGGTGGTTG	1	1
TATTTGCTTTATCTC	TATTTGCTTTATCTC	1	1
GCCTCTTTATCCCTG	GCCTCTTTATCCCTG	1	1
AGATTCAGAATGACA	AGATTCAGAATGACA	1	1
TGTCAAACCTCACGT	TGTCAAACCTCACGT	2	1
GTCCGCTGGTCATTT	GTCCGCTGGTCATTT	1	1
CACAGAAAAGGTCAT	CACAGAAAAGGTCAT	3	1
AATTTATCACTCTTA	AATTTATCACTCTTA	4	1
GCATTGGGTTCAGGA	GCATTGGGTTCAGGA	2	1
AGTGGGAGTGCTTGG	AGTGGGAGTGCTTGG	1	1
TCCTTCGACCTACGT	TCCTTCGACCTACGT	1	1
GGAGGGAGGAGTGGG	GGAGGGAGGAGTGGG	1	1
AATACATAGTCCTAG	AATACATAGTCCTAG	1	1
GGTCGATCGTTCAAC	GGTCGATCGTTCAAC	2	1
TGGTCATAAATGTAC	TGGTCATAAATGTAC	1	1
ATTGTCGTTAAAGTG	ATTGTCGTTAAAGTG	3	1
CCTAGACATTCGCGC	CCTAGACATTCGCGC	1	1
GGATTGCGACTGCTT	GGATTGCGACTGCTT	2	1
GATAGGTGCAATTTT	GATAGGTGCAATTTT	2	1
GCCATATTCATTATC	GCCATATTCATTATC	2	1
CGTTGTAAGTAAGGG	CGTTGTAAGTAAGGG	1	1
TGGCGGCAGGGGGTG	TGGCGGCAGGGGGTG	2	1
GTGAAAAACCTTATG	GTGAAAAACCTTATG	2	1
CGATCCGCTTAGGGA	CGATCCGCTTAGGGA	1	1
CTGAAGATGGTTCCA	CTGAAGATGGTTCCA	4	1
TCTGGGTGGTCGTTG	TCTGGGTGGTCGTTG	2	1
CGTCTGGTCCGCAAA	CGTCTGGTCCGCAAA	1	1
ACTCCGTGAATTCGC	ACTCCGTGAATTCGC	1	1
TATTTATGTTAGATT	TATTTATGTTAGATT	1	1
TGTCAAAGCAATAGT	TGTCAAAGCAATAGT	1	1
CATTGGAAGGGCGCG	CATTGGAAGGGCGCG	1	1
GGTGTTTGTTGATGT	GGTGTTTGTTGATGT	1	1
CGCCTGATACACGAC	CGCCTGATACACGAC	1	1
AACATAGGGTCACTT	AACATAGGGTCACTT	1	1
TGTACATACCAATCG	TGTACATACCAATCG	1	1
TGACCATGACCAATT	TGACCATGACCAATT	1	1
CTGTCATCGTCAGTT	CTGTCATCGTCAGTT	1	1
ACAATTCATATGCTT	ACAATTCATATGCTT	1	1
AAAGGCTTTTCCGTG	AAAGGCTTTTCCGTG	2	1
GATCGCCTAATTGTC	GATCGCCTAATTGTC	1	1
CTCAGTAACATCAGA	CTCAGTAACATCAGA	1	1
CTGCGCCAGCTCATA	CTGCGCCAGCTCATA	1	1
CGAGAGTCTTACCTG	CGAGAGTCTTACCTG	3	1
CTATCTGTCGTGCTA	CTATCTGTCGTGCTA	2	1
GGCGGGCGGCGGCGT	GGCGGGCGGCGGCGT	1	1
ATATCGTTGATAACG	ATATCGTTGATAACG	1	1
GGTTCTGGCATACAA	GGTTCTGGCATACAA	1	1
GTCGACGAGATGCCG	GTCGACGAGATGCCG	1	1
TCAACGGTTTCGGAA	TCAACGGTTTCGGAA	1	1
TTTCGAAAGCTCTAT	TTTCGAAAGCTCTAT	2	1
GACAACCATCTTATG	GACAACCATCTTATG	1	1
TCATAGGACAAGTTT	TCATAGGACAAGTTT	1	1
TTGAGTGTACATCTC	TTGAGTGTACATCTC	1	1
TGCACATAAATTGTT	TGCACATAAATTGTT	1	1
GCCTTCCGTTTCCAT	GCCTTCCGTTTCCAT	2	1
GCGCCTAGCCTAGTG	GCGCCTAGCCTAGTG	1	1
AAATAACTTCTAAAT	AAATAACTTCTAAAT	1	1
GACGGCTCGGGGGTG	GACGGCTCGGGGGTG	2	1
AGTTGAGTGTGATAA	AGTTGAGTGTGATAA	1	1
TTTTCGCATCATCGT	TTTTCGCATCATCGT	2	1
ATATAGTTCCGGCTT	ATATAGTTCCGGCTT	2	1
TGCGCTTTTGAGCCC	TGCGCTTTTGAGCCC	1	1
TAGAAGGTTTTCAAA	TAGAAGGTTTTCAAA	1	1
GGACGTGCTAATAGC	GGACGTGCTAATAGC	1	1
GGGGGGGAGCTATTG	GGGGGGGAGCTATTG	1	1
GTAGTCCAGTATGGG	GTAGTCCAGTATGGG	1	1
ATATACGTAACGCAA	ATATACGTAACGCAA	1	1
CTCCAGTATTCAAGA	CTCCAGTATTCAAGA	1	1
TCGTCTTACCTTCCT	TCGTCTTACCTTCCT	1	1
CATAAAGGCTGGGCC	CATAAAGGCTGGGCC	1	1
ACAGAAACGTTGTTG	ACAGAAACGTTGTTG	7	1
GGTCAGCTGTTCATT	GGTCAGCTGTTCATT	1	1
AGTGTCTAGTGGGTT	AGTGTCTAGTGGGTT	1	1
GGGCGGGTTTATGTT	GGGCGGGTTTATGTT	2	1
AAGGTATTTCAAGTG	AAGGTATTTCAAGTG	1	1
AACCTAAGGGTTGAA	AACCTAAGGGTTGAA	1	1
TCTAATACTGGTCAA	TCTAATACTGGTCAA	2	1
TGAATAATTTGAATC	TGAATAATTTGAATC	1	1
TTTTTGCTTCTGCAC	TTTTTGCTTCTGCAC	1	1
GTTGTTATTAGGCTA	GTTGTTATTAGGCTA	1	1
TACAGGATGCTTTAT	TACAGGATGCTTTAT	2	1
GCGCGGTACCATAGG	GCGCGGTACCATAGG	1	1
ATTGCCTGTTCAGCG	ATTGCCTGTTCAGCG	1	1
TTTATCGATTACTGA	TTTATCGATTACTGA	2	1
TACCGTTATCCGTCT	TACCGTTATCCGTCT	1	1
CTCACTTATTAGTTT	CTCACTTATTAGTTT	1	1
AACACTCTAATGTCA	AACACTCTAATGTCA	1	1
AACGGCGCCACGTTA	AACGGCGCCACGTTA	1	1
GGCGTTTTAATAGTA	GGCGTTTTAATAGTA	1	1
ATGTTTATGATTAAT	ATGTTTATGATTAAT	1	1
ATGACCTCACCTTCC	ATGACCTCACCTTCC	1	1
TGTACATGTAAATCT	TGTACATGTAAATCT	1	1
CTCGCCTTTCCAACA	CTCGCCTTTCCAACA	3	1
TGTCGAATTTGGGCG	TGTCGAATTTGGGCG	1	1
TACTGCTGCTCTTTA	TACTGCTGCTCTTTA	2	1
TATTTGGGCGATTGA	TATTTGGGCGATTGA	1	1
ATCCACGTTTCCATC	ATCCACGTTTCCATC	2	1
AGAGGAGATTATTAT	AGAGGAGATTATTAT	1	1
CTAGTGTCTTCGTAT	CTAGTGTCTTCGTAT	1	1
AATACAGAGCCGTGC	AATACAGAGCCGTGC	1	1
CCTTTGATTGCATTT	CCTTTGATTGCATTT	1	1
ACCTTCTGCAACTCG	ACCTTCTGCAACTCG	1	1
TTAACTGGCGTTTCG	TTAACTGGCGTTTCG	1	1
GTTTTTATGGTGGGT	GTTTTTATGGTGGGT	1	1
TACTAATCGCTGCTT	TACTAATCGCTGCTT	1	1
AGTTCGAGAAAATGA	AGTTCGAGAAAATGA	3	1
GCTAGGATACAGCAT	GCTAGGATACAGCAT	1	1
TAAGATCATATAATT	TAAGATCATATAATT	1	1
GATGTTCGAAGCATT	GATGTTCGAAGCATT	3	1
GAACAGATGAAATTT	GAACAGATGAAATTT	1	1
AATTCGTAAAAATGT	AATTCGTAAAAATGT	1	1
ATAAGGTATGGCCAA	ATAAGGTATGGCCAA	2	1
AAACAAGGTTCAATG	AAACAAGGTTCAATG	1	1
AAGTTGTGTCTAGAT	AAGTTGTGTCTAGAT	1	1
ATCGTCATATTACTT	ATCGTCATATTACTT	2	1
AGAGTGTGTTAAGGG	AGAGTGTGTTAAGGG	2	1
GGGATGCTTCTTGCT	GGGATGCTTCTTGCT	1	1
CTAACGGAATTTGAA	CTAACGGAATTTGAA	2	1
ATAAGAAGGGTATCG	ATAAGAAGGGTATCG	1	1
ATCCTGCCCTGATAT	ATCCTGCCCTGATAT	1	1
CACTGGAAGGAATTT	CACTGGAAGGAATTT	1	1
TCCGATTGATCTTCC	TCCGATTGATCTTCC	1	1
CTGAAGCTACAGCCT	CTGAAGCTACAGCCT	1	1
CGCATCATACCTTGG	CGCATCATACCTTGG	2	1
TGATCCAGGAAATTT	TGATCCAGGAAATTT	2	1
GTAAACAGTAGTCGG	GTAAACAGTAGTCGG	1	1
AGTAAAAGTTCACAA	AGTAAAAGTTCACAA	1	1
CTCGCGGGTCTTTCA	CTCGCGGGTCTTTCA	1	1
AGGGCGGCGGATGGG	AGGGCGGCGGATGGG	1	1
AGACATGAAATTGTT	AGACATGAAATTGTT	1	1
TAATAAACAGTGGTG	TAATAAACAGTGGTG	1	1
CAATGCGTGTTTCCC	CAATGCGTGTTTCCC	1	1
CGCTGGCCGGGGGCT	CGCTGGCCGGGGGCT	1	1
GGGTGGGATGGTTTG	GGGTGGGATGGTTTG	1	1
TTCTAATAGGATTCA	TTCTAATAGGATTCA	1	1
GGTGATTACTTAAAG	GGTGATTACTTAAAG	2	1
TTACTGTAGGAGGTG	TTACTGTAGGAGGTG	1	1
GCGCAAATTCGGTTT	GCGCAAATTCGGTTT	3	1
CAGATGGGCTTCCGT	CAGATGGGCTTCCGT	1	1
TCCTATGTGAGTGGC	TCCTATGTGAGTGGC	1	1
GCATTGTTTCAGCAT	GCATTGTTTCAGCAT	1	1
TCGATCAGCAGATCG	TCGATCAGCAGATCG	1	1
AATGATTACTTTCTG	AATGATTACTTTCTG	1	1
TGAATGATATCAGAT	TGAATGATATCAGAT	3	1
TTGAAGTATAAACGT	TTGAAGTATAAACGT	1	1
AGGTTAGCGTGGGTG	AGGTTAGCGTGGGTG	1	1
GGCACGGGGACTGTG	GGCACGGGGACTGTG	2	1
CATAGGATAACCATC	CATAGGATAACCATC	1	1
CTGGGGCTAATGTTG	CTGGGGCTAATGTTG	1	1
TAATGGTTGTATTTC	TAATGGTTGTATTTC	2	1
TGTCTAATCTATCTA	TGTCTAATCTATCTA	1	1
CTGAGGGTGACGGCT	CTGAGGGTGACGGCT	1	1
TATTTTGCTACGTTG	TATTTTGCTACGTTG	1	1
TATTTTGCTTAAGGT	TATTTTGCTTAAGGT	1	1
ACCAGCAATCTTTGT	ACCAGCAATCTTTGT	2	1
TGTCGTCACTCTGTT	TGTCGTCACTCTGTT	1	1
GAAGATGGTGTGGTG	GAAGATGGTGTGGTG	2	1
GACAATGCCGCACTC	GACAATGCCGCACTC	1	1
TTTTTCAACTTGTAT	TTTTTCAACTTGTAT	1	1
TAAGTTACTACGGAG	TAAGTTACTACGGAG	1	1
CGAGTTACTCCGCAA	CGAGTTACTCCGCAA	1	1
ATATGAAGTTTCCGT	ATATGAAGTTTCCGT	1	1
CGATATTTTTTATCA	CGATATTTTTTATCA	3	1
ACACTGACTAAGCGT	ACACTGACTAAGCGT	1	1
GTTGGCATGTTTATA	GTTGGCATGTTTATA	1	1
GTTTCTATTTATACT	GTTTCTATTTATACT	1	1
ACAGATGTGTTACGT	ACAGATGTGTTACGT	1	1
TCATCATATATATCT	TCATCATATATATCT	1	1
CATTCTAAATAGTAG	CATTCTAAATAGTAG	1	1
GGGCAGTAACATAGA	GGGCAGTAACATAGA	2	1
ATGTTGAGGCCTGTG	ATGTTGAGGCCTGTG	1	1
TACGGATCTAGGTAC	TACGGATCTAGGTAC	1	1
GTTTATGGTCGCCTT	GTTTATGGTCGCCTT	1	1
GGACTGCTGTTACTA	GGACTGCTGTTACTA	1	1
AAATGTGGAATACCT	AAATGTGGAATACCT	2	1
GGTTTAGAGGTCGGG	GGTTTAGAGGTCGGG	1	1
CTCGGTGGCAACAAT	CTCGGTGGCAACAAT	2	1
TGATGTAATATTTCA	TGATGTAATATTTCA	4	1
GTCCGATTTACGTCT	GTCCGATTTACGTCT	1	1
CGACAAATGGGCTTC	CGACAAATGGGCTTC	3	1
CTTACCCGCGTGTGG	CTTACCCGCGTGTGG	2	1
CTTCCCGCGACTTCC	CTTCCCGCGACTTCC	2	1
ACGTACTGTACCCAC	ACGTACTGTACCCAC	1	1
CATTTTTTGTAACTG	CATTTTTTGTAACTG	2	1
AAGTTCCTCAGGTAT	AAGTTCCTCAGGTAT	1	1
TTTACCTAGTTGGAG	TTTACCTAGTTGGAG	1	1
AATTATGAGTCTCGT	AATTATGAGTCTCGT	1	1
TATACGCATCTGTGC	TATACGCATCTGTGC	2	1
TTATTAGATGCTTTT	TTATTAGATGCTTTT	1	1
TGACAGCATTATTAC	TGACAGCATTATTAC	1	1
TTATCATCACACATT	TTATCATCACACATT	1	1
GGGAGGCGGGGGGCG	GGGAGGCGGGGGGCG	1	1
CTTTTGTTTTATAAA	CTTTTGTTTTATAAA	1	1
CTTATATGAGCGCCG	CTTATATGAGCGCCG	2	1
CGATGTACGGACAAT	CGATGTACGGACAAT	1	1
TAGGAGTCAAGATTG	TAGGAGTCAAGATTG	1	1
TAACGAGGTCAAAGA	TAACGAGGTCAAAGA	1	1
CAATTGTAGTTAGCT	CAATTGTAGTTAGCT	1	1
TAATCATATATATGG	TAATCATATATATGG	1	1
CGAGCGATTAATATT	CGAGCGATTAATATT	2	1
CAAGGCCTGAAGGAG	CAAGGCCTGAAGGAG	1	1
GCGACCTTTGTTTGT	GCGACCTTTGTTTGT	1	1
CTTTACGGTTGGCAA	CTTTACGGTTGGCAA	1	1
ATAACCTACAAGATT	ATAACCTACAAGATT	1	1
TTGACGTTAGCATTC	TTGACGTTAGCATTC	1	1
ACAACGGTTTTTATT	ACAACGGTTTTTATT	1	1
GGGTCGCTTTTTTTA	GGGTCGCTTTTTTTA	2	1
GGGTGAGTGTTTGGG	GGGTGAGTGTTTGGG	2	1
GCATTTTGTTATGAG	GCATTTTGTTATGAG	1	1
GTTAGCATCCAAACT	GTTAGCATCCAAACT	2	1
AATCATACAGTGATT	AATCATACAGTGATT	1	1
GGCGATGGATCTGTG	GGCGATGGATCTGTG	3	1
TGTGCCATAGTGGTT	TGTGCCATAGTGGTT	3	1
CCATTCTGCCAAAAT	CCATTCTGCCAAAAT	1	1
ATAGCTAAAACCGGA	ATAGCTAAAACCGGA	1	1
GTAGCTTACGTCCGT	GTAGCTTACGTCCGT	1	1
TTACGTTGAGACTTT	TTACGTTGAGACTTT	2	1
CAAGGCATGCTGTGT	CAAGGCATGCTGTGT	1	1
AGGGGTGGAACTCGC	AGGGGTGGAACTCGC	2	1
ATTCTGCTGTCTTTT	ATTCTGCTGTCTTTT	2	1
TCTCAGGGATCAGTA	TCTCAGGGATCAGTA	3	1
CTCGGAATGGATAAA	CTCGGAATGGATAAA	1	1
TCACCGTGTAGAGCT	TCACCGTGTAGAGCT	1	1
ACGTGAGAGAGAAGT	ACGTGAGAGAGAAGT	1	1
GGTCGATGAAGTTGG	GGTCGATGAAGTTGG	1	1
TTATTTTTGCATACG	TTATTTTTGCATACG	1	1
GACGGGACGACCCAT	GACGGGACGACCCAT	2	1
TAAAAGTGGCACAAT	TAAAAGTGGCACAAT	3	1
CTCTATTGGCTATTA	CTCTATTGGCTATTA	2	1
GTATTTTGATTTTAT	GTATTTTGATTTTAT	1	1
AGATACCGAATACAA	AGATACCGAATACAA	2	1
GCACTTACATATGGG	GCACTTACATATGGG	1	1
TCGGTCAGATCAACT	TCGGTCAGATCAACT	3	1
CAGCCGTAACCTAAA	CAGCCGTAACCTAAA	1	1
GGGCTTGATTCGTGT	GGGCTTGATTCGTGT	1	1
GAGGTGCGGGGGGTG	GAGGTGCGGGGGGTG	1	1
TCGCTGTGTCTCTCA	TCGCTGTGTCTCTCA	1	1
TAACAACAGATGAAT	TAACAACAGATGAAT	1	1
CGCTAGGTCTCTTAA	CGCTAGGTCTCTTAA	1	1
TGCATCCAGGGTTAT	TGCATCCAGGGTTAT	1	1
GCGCCTTCTGTGTGG	GCGCCTTCTGTGTGG	1	1
TAACCGATGAGCGCA	TAACCGATGAGCGCA	2	1
AGATGCGACATATGA	AGATGCGACATATGA	1	1
CGCCTTCTCGTGGTG	CGCCTTCTCGTGGTG	1	1
CTACATACTATCTAT	CTACATACTATCTAT	1	1
TTTGGTATGCTTTCA	TTTGGTATGCTTTCA	1	1
TTGCTGATCCAAACG	TTGCTGATCCAAACG	1	1
GGTTTTCTGCGCTTC	GGTTTTCTGCGCTTC	1	1
ATGATGATGTATGTC	ATGATGATGTATGTC	1	1
CAGGTTCCATCCATT	CAGGTTCCATCCATT	3	1
CAAGCCACGTGCGAT	CAAGCCACGTGCGAT	1	1
TACCTATAGCCGTGA	TACCTATAGCCGTGA	4	1
ATATGCACACGCCAG	ATATGCACACGCCAG	2	1
ACCTACACTCCTTCT	ACCTACACTCCTTCT	2	1
GTGCGTCCGTATTAG	GTGCGTCCGTATTAG	1	1
TCTCTTTTCCATCTC	TCTCTTTTCCATCTC	1	1
GCGAAGAGGTATGCT	GCGAAGAGGTATGCT	1	1
ATCGTAGTTGCCCGT	ATCGTAGTTGCCCGT	2	1
ACATGGAGTGCATGC	ACATGGAGTGCATGC	2	1
GCGCAAATCGTACGG	GCGCAAATCGTACGG	1	1
ATGATGGATTTGTAT	ATGATGGATTTGTAT	1	1
GGTTGGGATTCCATC	GGTTGGGATTCCATC	1	1
CGATGATGGAAACGA	CGATGATGGAAACGA	2	1
TTTCTGTTACGAACT	TTTCTGTTACGAACT	3	1
AACTTGGCACTCTGA	AACTTGGCACTCTGA	2	1
TGATCGTGGTCTTCA	TGATCGTGGTCTTCA	1	1
CTCGTGAAATACCAA	CTCGTGAAATACCAA	1	1
CATGCGTCTATAGGA	CATGCGTCTATAGGA	1	1
CACTCATTCTCCCCA	CACTCATTCTCCCCA	1	1
CAGTTTTGGGAGTTA	CAGTTTTGGGAGTTA	1	1
GGTGGTGGGAAAGGT	GGTGGTGGGAAAGGT	1	1
AAACTTTAAGGGTTG	AAACTTTAAGGGTTG	1	1
CAAATAGCGCTGATT	CAAATAGCGCTGATT	1	1
AGCACCGGTGAACAT	AGCACCGGTGAACAT	1	1
ATTCTGCAGAATCGT	ATTCTGCAGAATCGT	1	1
TGATGTAATATTTAA	TGATGTAATATTTAA	1	1
GGGCGCGATATAAAG	GGGCGCGATATAAAG	1	1
TCACCAAACGCGTAA	TCACCAAACGCGTAA	1	1
ATCAACATTGGATTA	ATCAACATTGGATTA	1	1
CACTTTGTAACAATG	CACTTTGTAACAATG	2	1
TAATGGGCTGTTACT	TAATGGGCTGTTACT	1	1
ACCTGGGCAGGGCTT	ACCTGGGCAGGGCTT	2	1
TGGAAACCAATTGGT	TGGAAACCAATTGGT	1	1
AGATGTTTGATTTCT	AGATGTTTGATTTCT	2	1
ATTGGAAGTAATGTA	ATTGGAAGTAATGTA	1	1
ACGTGTAGTGGTTAA	ACGTGTAGTGGTTAA	1	1
AACGACTAGATGGGT	AACGACTAGATGGGT	1	1
GCTTAATTCCCCAGT	GCTTAATTCCCCAGT	1	1
ACATCCAAACATCTG	ACATCCAAACATCTG	1	1
GGTGTGGGTGCCAGG	GGTGTGGGTGCCAGG	2	1
TTCTAAGCAGCCATA	TTCTAAGCAGCCATA	2	1
GTTATGCTTTGATCG	GTTATGCTTTGATCG	1	1
ACCAGTGGCGAGGTT	ACCAGTGGCGAGGTT	1	1
ATCGAGTCATAATGT	ATCGAGTCATAATGT	1	1
AATTTTAGACGTTCG	AATTTTAGACGTTCG	1	1
CCCTAACACCTTGAC	CCCTAACACCTTGAC	1	1
CATACTTTATTAAAC	CATACTTTATTAAAC	1	1
ATGCTAGGCGCCTTT	ATGCTAGGCGCCTTT	1	1
CATTTATATTAGCTG	CATTTATATTAGCTG	1	1
AAAGGACTGTAATTA	AAAGGACTGTAATTA	1	1
GGTCAGGGGTCAGGT	GGTCAGGGGTCAGGT	1	1
TCCAAAAACCTCTGT	TCCAAAAACCTCTGT	2	1
GAGCTGCCTATGATT	GAGCTGCCTATGATT	2	1
TGGTTTTATGGCTTG	TGGTTTTATGGCTTG	3	1
GATGGCTTGGTCTTG	GATGGCTTGGTCTTG	4	1
TGTGGTGGATCCGGG	TGTGGTGGATCCGGG	1	1
GAATATTGCGAGTCA	GAATATTGCGAGTCA	2	1
AATACTACTAATGTA	AATACTACTAATGTA	1	1
TATTGTGTTAAACTT	TATTGTGTTAAACTT	1	1
CAAGCATTACTCCAA	CAAGCATTACTCCAA	1	1
AAATGGGAAGGGGTA	AAATGGGAAGGGGTA	3	1
CGCTGGGTCTCATCA	CGCTGGGTCTCATCA	1	1
TTTCGGGTAATGGTT	TTTCGGGTAATGGTT	1	1
AGAAAGTAGTTAGTT	AGAAAGTAGTTAGTT	1	1
CCCTCTAGCGACTGC	CCCTCTAGCGACTGC	1	1
TTAGTGTTTGAGGTG	TTAGTGTTTGAGGTG	2	1
GATTTTAATCCGTCG	GATTTTAATCCGTCG	1	1
TTATGTGTCAGGGTA	TTATGTGTCAGGGTA	1	1
TCCCGCAACCACTTC	TCCCGCAACCACTTC	1	1
GCTGTGTTTTTGTGT	GCTGTGTTTTTGTGT	3	1
CAATTTTGGGTGCGT	CAATTTTGGGTGCGT	2	1
CTAACCTATTGGATA	CTAACCTATTGGATA	1	1
TTTCCGCGCGCAATC	TTTCCGCGCGCAATC	1	1
GGCTGTTGGATGGGG	GGCTGTTGGATGGGG	2	1
GTTAAAGCGTTATTA	GTTAAAGCGTTATTA	2	1
ATTATTTATGGGAAT	ATTATTTATGGGAAT	1	1
ACACCCTTCTTAAGT	ACACCCTTCTTAAGT	2	1
TGAGTACATGACTAT	TGAGTACATGACTAT	1	1
ACAAACTTCTCAGAG	ACAAACTTCTCAGAG	3	1
CTCTATATCAATGAT	CTCTATATCAATGAT	1	1
TTCTGTCGCCAACTT	TTCTGTCGCCAACTT	1	1
ACTCAGCATAATCTT	ACTCAGCATAATCTT	2	1
TTGGGATTGTCCTCA	TTGGGATTGTCCTCA	2	1
GGCTCAGGGAGTTAT	GGCTCAGGGAGTTAT	3	1
ACCATTTCACTCATT	ACCATTTCACTCATT	4	1
AAGAGAGGGGTGGTA	AAGAGAGGGGTGGTA	1	1
CCAGGCTCCTAGAGT	CCAGGCTCCTAGAGT	1	1
GCGGCTAAGCGTTAA	GCGGCTAAGCGTTAA	1	1
ATCCCGTGAGTCATT	ATCCCGTGAGTCATT	2	1
TAAACGCAATTGATC	TAAACGCAATTGATC	1	1
TGCCGAGCGTTATCA	TGCCGAGCGTTATCA	1	1
AACGCGAACTAGGGT	AACGCGAACTAGGGT	3	1
CTATTGTTTTCACTG	CTATTGTTTTCACTG	2	1
TGCGATGTGAAGTAT	TGCGATGTGAAGTAT	1	1
CAATGCGTACTGGTT	CAATGCGTACTGGTT	2	1
TAGTGTGGCAATCAT	TAGTGTGGCAATCAT	1	1
CAACGACTAACCTTG	CAACGACTAACCTTG	1	1
CTTGCTATGTTTTGG	CTTGCTATGTTTTGG	1	1
ATCTGTATGTAATAT	ATCTGTATGTAATAT	1	1
TGATGTCGCCTGTTT	TGATGTCGCCTGTTT	1	1
GTTGATAATATGTGT	GTTGATAATATGTGT	1	1
TAATGAGCTAGTGTA	TAATGAGCTAGTGTA	1	1
TTGCTGGGGGTCGTG	TTGCTGGGGGTCGTG	1	1
TTACAATTAATGTCG	TTACAATTAATGTCG	1	1
AAACCATTCTATCAT	AAACCATTCTATCAT	1	1
GAGTAGGTTAGTGCA	GAGTAGGTTAGTGCA	3	1
ATTTTAGGCATCTGA	ATTTTAGGCATCTGA	3	1
CCTCCTGACTCCGTC	CCTCCTGACTCCGTC	2	1
AGCTTGGATTAATTT	AGCTTGGATTAATTT	1	1
TCAGTACGTGTGTTA	TCAGTACGTGTGTTA	2	1
GGTCATAGATTAGGG	GGTCATAGATTAGGG	1	1
AATTTCTACACATCA	AATTTCTACACATCA	1	1
AACCGGAAAGGTAAC	AACCGGAAAGGTAAC	1	1
GGCTTGGATTATTCC	GGCTTGGATTATTCC	1	1
AGTGGCCCTAGGTGT	AGTGGCCCTAGGTGT	1	1
ACATCGTAATTATGT	ACATCGTAATTATGT	3	1
CACACACCTCTCGAT	CACACACCTCTCGAT	2	1
GACATCGATTAAGTA	GACATCGATTAAGTA	2	1
CTTGCAAGCTTTCTT	CTTGCAAGCTTTCTT	1	1
ATTCGAGGCCTTTTT	ATTCGAGGCCTTTTT	1	1
ATCTCTATTGTTGTC	ATCTCTATTGTTGTC	1	1
GCGCTTTGGTTGGGG	GCGCTTTGGTTGGGG	1	1
CGGGATTTTGTGTTT	CGGGATTTTGTGTTT	2	1
ATACGTCTCATTTCG	ATACGTCTCATTTCG	2	1
AACATTGTTCAAGCT	AACATTGTTCAAGCT	2	1
TCCGGCTTCGAAATG	TCCGGCTTCGAAATG	1	1
GGGGGGCGGGGAGCG	GGGGGGCGGGGAGCG	2	1
TAAATACCCTCTCGG	TAAATACCCTCTCGG	2	1
CCATCTTTAATAAAT	CCATCTTTAATAAAT	1	1
TCCTGAAGTCGGCTG	TCCTGAAGTCGGCTG	1	1
GTATGAAGTTATGTT	GTATGAAGTTATGTT	1	1
TGACGTGCTGCATGA	TGACGTGCTGCATGA	1	1
GTAATTCGGAAAGCA	GTAATTCGGAAAGCA	1	1
TATAGCGATATAAAA	TATAGCGATATAAAA	1	1
GATGCCACGGTGTTA	GATGCCACGGTGTTA	2	1
TCAGGAATTAGCACT	TCAGGAATTAGCACT	1	1
ATATGTTGATGTCGA	ATATGTTGATGTCGA	2	1
GCAGGAGGGAACAAC	GCAGGAGGGAACAAC	2	1
TATATCCTTAATAGA	TATATCCTTAATAGA	1	1
TAGAACATTCTTCGT	TAGAACATTCTTCGT	1	1
CCCGTGCGTAGTAAC	CCCGTGCGTAGTAAC	1	1
ATTTCTGGAATAGAT	ATTTCTGGAATAGAT	2	1
CATATATTGTAAGGT	CATATATTGTAAGGT	1	1
CGAGATGATACCTGT	CGAGATGATACCTGT	1	1
ACTATATTTCACTGT	ACTATATTTCACTGT	1	1
AGCACACCGTCAACT	AGCACACCGTCAACT	1	1
TTGAAAAACCTCACG	TTGAAAAACCTCACG	1	1
TAATTCAACAAGTTC	TAATTCAACAAGTTC	1	1
GTATTTGTCCGTTGA	GTATTTGTCCGTTGA	1	1
ACTGGTGAGGGGACG	ACTGGTGAGGGGACG	1	1
TTAAGGGCTATTCCA	TTAAGGGCTATTCCA	1	1
GTTAACATGCGCATT	GTTAACATGCGCATT	1	1
GACTAATCTTTGGTG	GACTAATCTTTGGTG	1	1
ATTGAGAATATGACT	ATTGAGAATATGACT	1	1
TGTTGCAGTAAGAGA	TGTTGCAGTAAGAGA	2	1
CTGTATTCCTACAAA	CTGTATTCCTACAAA	3	1
TTTCACACTTAAGTT	TTTCACACTTAAGTT	1	1
TAAGGATCCAATAAT	TAAGGATCCAATAAT	1	1
GTCGGTAGACGGATG	GTCGGTAGACGGATG	1	1
GTTATCTGTTTGGTT	GTTATCTGTTTGGTT	1	1
CTTTACGTATCCAAA	CTTTACGTATCCAAA	1	1
TATTCCGTATACGCA	TATTCCGTATACGCA	3	1
CGAACGCCTTTATAT	CGAACGCCTTTATAT	1	1
GTTGTTAATGATAGG	GTTGTTAATGATAGG	2	1
ACCATCAGTTAAGTT	ACCATCAGTTAAGTT	1	1
CTACCTGTCGTACAA	CTACCTGTCGTACAA	1	1
ATTCTGAGAACTGCG	ATTCTGAGAACTGCG	1	1
GTTTTCACTTGGAGT	GTTTTCACTTGGAGT	1	1
CTACCACATTTTAGT	CTACCACATTTTAGT	1	1
TACTGCGCGGGAGTG	TACTGCGCGGGAGTG	1	1
TCCGACGATATGTAA	TCCGACGATATGTAA	3	1
CTACGAGCCGTGCGC	CTACGAGCCGTGCGC	1	1
ATAGCTAAACGTCAC	ATAGCTAAACGTCAC	1	1
ACCACGAATTAACAT	ACCACGAATTAACAT	1	1
GATCAGTCGGTCTTC	GATCAGTCGGTCTTC	2	1
GGTGCCGGGATTGAT	GGTGCCGGGATTGAT	1	1
TTATGATGTATTTAT	TTATGATGTATTTAT	1	1
AAAATAGCTATCCTC	AAAATAGCTATCCTC	2	1
AATGATTACACTTAA	AATGATTACACTTAA	1	1
ATACCCACGGCATTT	ATACCCACGGCATTT	2	1
GGCTTCCATCCTAAT	GGCTTCCATCCTAAT	1	1
CTTCTAGTAACAAGA	CTTCTAGTAACAAGA	2	1
AATGTTCGCCATAAT	AATGTTCGCCATAAT	2	1
TGGGGAATTTACAAG	TGGGGAATTTACAAG	1	1
TGTAGAGATACTATT	TGTAGAGATACTATT	1	1
CCAGGAAAAGCGTAA	CCAGGAAAAGCGTAA	1	1
TGACACTAAGTTTCC	TGACACTAAGTTTCC	1	1
AATAAGAAAGTAAAA	AATAAGAAAGTAAAA	1	1
CCGTTCGGACACGTC	CCGTTCGGACACGTC	1	1
AAGGACTTTGGGACA	AAGGACTTTGGGACA	1	1
TGGGAGGAGTTTAGC	TGGGAGGAGTTTAGC	1	1
TGAAGGCACTTCGTA	TGAAGGCACTTCGTA	1	1
ACTACAAGACTGCGT	ACTACAAGACTGCGT	1	1
TTTACCTATTAGAAA	TTTACCTATTAGAAA	1	1
AAATCGCTCGTCGAG	AAATCGCTCGTCGAG	1	1
GCAGAAGTTTAGGTC	GCAGAAGTTTAGGTC	3	1
GAACAGCTTTTAGAA	GAACAGCTTTTAGAA	2	1
GGTTATATCCCGGGA	GGTTATATCCCGGGA	1	1
TTAGACGGGCTTCTG	TTAGACGGGCTTCTG	1	1
TATTCATATCGTTGG	TATTCATATCGTTGG	2	1
AGCGATTTTGCGCGG	AGCGATTTTGCGCGG	1	1
CATGTGAACACATGA	CATGTGAACACATGA	1	1
GCTTCCGCTCATGGG	GCTTCCGCTCATGGG	1	1
CATGACGGGGAGGTC	CATGACGGGGAGGTC	1	1
AGGCACATTATAGTT	AGGCACATTATAGTT	1	1
AGGATTAGGGCCTGT	AGGATTAGGGCCTGT	1	1
CATCGTTCGTCCTCC	CATCGTTCGTCCTCC	1	1
ATCTAATGTAGCACT	ATCTAATGTAGCACT	1	1
GTTATCGGATGCATC	GTTATCGGATGCATC	1	1
CTGTAATAAAGATGA	CTGTAATAAAGATGA	1	1
TACGGTAATTAACGT	TACGGTAATTAACGT	2	1
ATTGAACTCGATCTT	ATTGAACTCGATCTT	2	1
CTAACTCGACGAGCT	CTAACTCGACGAGCT	1	1
CGTAATGCGATGCGG	CGTAATGCGATGCGG	1	1
TAATTCGATTAGATT	TAATTCGATTAGATT	1	1
CAATGCACATAGATG	CAATGCACATAGATG	4	1
GACGAAAGGATGGGG	GACGAAAGGATGGGG	1	1
TTACGAGTGCCTCTA	TTACGAGTGCCTCTA	2	1
TGTTGTGAAATGTCG	TGTTGTGAAATGTCG	1	1
ACCTGGTTATTTTTT	ACCTGGTTATTTTTT	2	1
AATATAAGGACAGCG	AATATAAGGACAGCG	1	1
GCATATATTATATGG	GCATATATTATATGG	1	1
TTTAGTTGCTCGCTC	TTTAGTTGCTCGCTC	1	1
CGAAAGATATCTTTT	CGAAAGATATCTTTT	2	1
CATCCTTCATAGGGT	CATCCTTCATAGGGT	5	1
TTCTGATTGTAAAAG	TTCTGATTGTAAAAG	1	1
GTCAACTTTGTTCAT	GTCAACTTTGTTCAT	1	1
AATAATACAAATTCT	AATAATACAAATTCT	1	1
GACTTTGTAAAGGAG	GACTTTGTAAAGGAG	2	1
CGCAGACGGCTCGGT	CGCAGACGGCTCGGT	1	1
GTCAATCTTAGTGTG	GTCAATCTTAGTGTG	1	1
GCGCCTTCCGAGTTC	GCGCCTTCCGAGTTC	2	1
TCTCACGCTACCGTA	TCTCACGCTACCGTA	2	1
GTAGAAGTTATAGTG	GTAGAAGTTATAGTG	1	1
ACGTGGTCGCAATTT	ACGTGGTCGCAATTT	2	1
TCCCTTTTGGTTGGA	TCCCTTTTGGTTGGA	1	1
TGTTTTACTCCAACG	TGTTTTACTCCAACG	1	1
CTCGTCATAGATCGG	CTCGTCATAGATCGG	1	1
ATTCTGGGGCCGTAT	ATTCTGGGGCCGTAT	1	1
TTCACAGATCTAATC	TTCACAGATCTAATC	1	1
CCAACTCTCCTTGAG	CCAACTCTCCTTGAG	1	1
TATTTTCAAACGCTA	TATTTTCAAACGCTA	2	1
TGTGCTGACCATACA	TGTGCTGACCATACA	1	1
TTACGTACCATAGCT	TTACGTACCATAGCT	1	1
TAGTACCTCAATTCT	TAGTACCTCAATTCT	1	1
ATATTGTTCGAGACT	ATATTGTTCGAGACT	1	1
CTCCTTATCACTTTC	CTCCTTATCACTTTC	1	1
TTAACCTGGTAGATG	TTAACCTGGTAGATG	3	1
AATAGTTTAATCATA	AATAGTTTAATCATA	2	1
CTATAAGGGTGGTGA	CTATAAGGGTGGTGA	1	1
CTATACTCAATCGGA	CTATACTCAATCGGA	1	1
ACTTTCCGCGTTGGT	ACTTTCCGCGTTGGT	1	1
TAACTCTGTGGGACC	TAACTCTGTGGGACC	2	1
AACTACTTGTCCATA	AACTACTTGTCCATA	1	1
TACCTTCGTTGCTAA	TACCTTCGTTGCTAA	1	1
TTGAACCATACACTT	TTGAACCATACACTT	1	1
GAATTATGGATTGGA	GAATTATGGATTGGA	1	1
ATGGTTTACGCAAGT	ATGGTTTACGCAAGT	2	1
GAACGAATGGGGTGG	GAACGAATGGGGTGG	1	1
GATGTCCAAACAAAC	GATGTCCAAACAAAC	1	1
ATAGCTTATATTTTT	ATAGCTTATATTTTT	1	1
TTACGAGGCTAATCA	TTACGAGGCTAATCA	3	1
TTACAAACTACAACA	TTACAAACTACAACA	8	1
TTTGTATTGTTTATG	TTTGTATTGTTTATG	1	1
ACTGCATTTTTTGGT	ACTGCATTTTTTGGT	1	1
TTCAATCACGGCTGT	TTCAATCACGGCTGT	1	1
TGGAAGGACTGTGAG	TGGAAGGACTGTGAG	2	1
CTCGTGCGGTGTTCC	CTCGTGCGGTGTTCC	1	1
TATCCTTGCGGCTAA	TATCCTTGCGGCTAA	1	1
CTTCCGAGTTTCAGT	CTTCCGAGTTTCAGT	3	1
AATATAAGTAGATAT	AATATAAGTAGATAT	2	1
TCTGCACGTAAATCA	TCTGCACGTAAATCA	1	1
ATCAAGATGTTAACA	ATCAAGATGTTAACA	4	1
CAACGTGGGTCTGTG	CAACGTGGGTCTGTG	2	1
CTAATTTAATGGGGA	CTAATTTAATGGGGA	1	1
TGCAATAAATAAGCG	TGCAATAAATAAGCG	2	1
TTTGGGTACAGCTTG	TTTGGGTACAGCTTG	2	1
TTTAACCCACTCGAA	TTTAACCCACTCGAA	1	1
TTTCTATGGCCTCTT	TTTCTATGGCCTCTT	2	1
GCAATGCTGCCACTC	GCAATGCTGCCACTC	1	1
GCCGAACGCATACTG	GCCGAACGCATACTG	1	1
AGTCCCGTGTACCTC	AGTCCCGTGTACCTC	1	1
TTACAAGCATCACCA	TTACAAGCATCACCA	1	1
TTGGCAGAACTGGAC	TTGGCAGAACTGGAC	1	1
TTTTTTTTGGTCCTT	TTTTTTTTGGTCCTT	1	1
CTTGACTGCAATTAA	CTTGACTGCAATTAA	1	1
CAAGCTTATAAGCGT	CAAGCTTATAAGCGT	1	1
CACTGCCAATTGGTC	CACTGCCAATTGGTC	1	1
GGACGTCAAATAACA	GGACGTCAAATAACA	2	1
CTGATGCATCAACGA	CTGATGCATCAACGA	1	1
GCTTGAATCTAGGCC	GCTTGAATCTAGGCC	1	1
GGTTGGAATTTTACT	GGTTGGAATTTTACT	1	1
TATAGCGGTCCAACA	TATAGCGGTCCAACA	1	1
CAGGTCAGTTAAATT	CAGGTCAGTTAAATT	1	1
GAAGTACACCCCAAG	GAAGTACACCCCAAG	1	1
ACAATCGAAAATGTT	ACAATCGAAAATGTT	1	1
TGTCGCAGCATGTCT	TGTCGCAGCATGTCT	1	1
CGACAAGAACTTTTT	CGACAAGAACTTTTT	1	1
TTTTAAATTAGTACA	TTTTAAATTAGTACA	2	1
CGATAAAGCGAAATC	CGATAAAGCGAAATC	1	1
TATAGGGTTGCTTTA	TATAGGGTTGCTTTA	1	1
GATTATGGTAATCCT	GATTATGGTAATCCT	1	1
ATAGTGAAGTTGTAG	ATAGTGAAGTTGTAG	1	1
CCTCATCTAAACATA	CCTCATCTAAACATA	1	1
ACTGTGCTCTGCGTT	ACTGTGCTCTGCGTT	2	1
TGGGTACGGGAGTAT	TGGGTACGGGAGTAT	4	1
ATGAGAATATACTTT	ATGAGAATATACTTT	1	1
TACTCTAACACATCT	TACTCTAACACATCT	3	1
CTCACTACTCTTGTT	CTCACTACTCTTGTT	1	1
CTATTTTGGCTGCGA	CTATTTTGGCTGCGA	1	1
TACCACGCAGATACA	TACCACGCAGATACA	1	1
GTTCACGGTTACGCT	GTTCACGGTTACGCT	1	1
AGTAAGGATTGTTTA	AGTAAGGATTGTTTA	2	1
TTTGTTGATTTGTTT	TTTGTTGATTTGTTT	1	1
TCTGTGATTCTGTAA	TCTGTGATTCTGTAA	1	1
GTTACACCTTTACTA	GTTACACCTTTACTA	1	1
GGTCTTGAATTAGAT	GGTCTTGAATTAGAT	1	1
TGCATCTATATGTCG	TGCATCTATATGTCG	1	1
TTGATATAAAGGTGA	TTGATATAAAGGTGA	1	1
GTAAAATAGCAAACA	GTAAAATAGCAAACA	1	1
TTGCCACCGTAATTG	TTGCCACCGTAATTG	2	1
ATATCTAATAAACTA	ATATCTAATAAACTA	1	1
GTTTGGCATGATGTA	GTTTGGCATGATGTA	1	1
ATATTTGGGAATTGT	ATATTTGGGAATTGT	1	1
TTTTACATGTTGTTT	TTTTACATGTTGTTT	1	1
AGTGTTTAACTTTTA	AGTGTTTAACTTTTA	1	1
GATGGGTGGACTTCC	GATGGGTGGACTTCC	1	1
GGTTGGAGATCTGTC	GGTTGGAGATCTGTC	2	1
GGATTTTACCGCTAT	GGATTTTACCGCTAT	3	1
AAGGATTCTTCAACT	AAGGATTCTTCAACT	1	1
GGCACACGGATCGCT	GGCACACGGATCGCT	1	1
GGAGATATTTAATAG	GGAGATATTTAATAG	1	1
TCTACCTGTTAATTT	TCTACCTGTTAATTT	1	1
CCATAACTTTCCTCT	CCATAACTTTCCTCT	1	1
TGAAGACAGTAGGCG	TGAAGACAGTAGGCG	1	1
GAGGCAGTGCTGCAA	GAGGCAGTGCTGCAA	4	1
GACGTATCCGTTTTT	GACGTATCCGTTTTT	3	1
ATATGACCAGTTTTC	ATATGACCAGTTTTC	1	1
CTATTGTACTGATGG	CTATTGTACTGATGG	1	1
TTTCCTTCTACAAAA	TTTCCTTCTACAAAA	2	1
GTAAAGCAATGAGTT	GTAAAGCAATGAGTT	1	1
TATTTGGGGAATCAT	TATTTGGGGAATCAT	1	1
AGTACGGGTTTAAAA	AGTACGGGTTTAAAA	1	1
CATCCGGGAGAGTCT	CATCCGGGAGAGTCT	1	1
CGAGTAAGAGGCATA	CGAGTAAGAGGCATA	1	1
ACTGGTGTCGTTTTC	ACTGGTGTCGTTTTC	1	1
CTTACAAGAGCGCCT	CTTACAAGAGCGCCT	1	1
AGCTCACAAGCTTAG	AGCTCACAAGCTTAG	1	1
CGTGCTAGCTAAGAT	CGTGCTAGCTAAGAT	2	1
CAGGTAAGCCATATT	CAGGTAAGCCATATT	2	1
TTCTTCTCAATTTTA	TTCTTCTCAATTTTA	1	1
GGTTGAATACTAAAT	GGTTGAATACTAAAT	1	1
CGAAGTTAAGATATT	CGAAGTTAAGATATT	1	1
CGCATTGATATCAGA	CGCATTGATATCAGA	1	1
TGTTCCTACGCTGTG	TGTTCCTACGCTGTG	1	1
TGGCAATCCTCTTAC	TGGCAATCCTCTTAC	1	1
ACTGCCCTATCGATT	ACTGCCCTATCGATT	1	1
GATGAGGAAGCTTGT	GATGAGGAAGCTTGT	1	1
TTCAGATTGATACAA	TTCAGATTGATACAA	3	1
GCATTGAGTGATAAT	GCATTGAGTGATAAT	1	1
TTTTTCACAATAAAT	TTTTTCACAATAAAT	1	1
AACGTTGATTAGTAA	AACGTTGATTAGTAA	2	1
GGACGCATGGTGGGT	GGACGCATGGTGGGT	1	1
TGAGTATGGCGCGCC	TGAGTATGGCGCGCC	1	1
TGTGCGCATATCCAC	TGTGCGCATATCCAC	1	1
TTTGTACTTGCGTTT	TTTGTACTTGCGTTT	1	1
TCCTCACGGTTTTGT	TCCTCACGGTTTTGT	2	1
ATATATTGTATTGGA	ATATATTGTATTGGA	2	1
CATGTAGATTTGTGA	CATGTAGATTTGTGA	2	1
TTTTTACTGGTTTGT	TTTTTACTGGTTTGT	1	1
GATTGATTTTCGCTC	GATTGATTTTCGCTC	1	1
CTTTCGCATACTGGT	CTTTCGCATACTGGT	1	1
GGTTACAGATTATGT	GGTTACAGATTATGT	1	1
TTACGTATGCCTTGT	TTACGTATGCCTTGT	1	1
TTAGTTCCTTAAAAA	TTAGTTCCTTAAAAA	3	1
TAGCGGTGGCGGGGG	TAGCGGTGGCGGGGG	1	1
ATTATGCTCCGTATA	ATTATGCTCCGTATA	1	1
ACACTCATATTTTTC	ACACTCATATTTTTC	1	1
CAGAAAGTTAAGTTC	CAGAAAGTTAAGTTC	1	1
GCGGAATGCAGCCGT	GCGGAATGCAGCCGT	1	1
AAGTCCACAAATGCG	AAGTCCACAAATGCG	2	1
AGTGGGAGGGTGAAA	AGTGGGAGGGTGAAA	2	1
TGCGACAGGGGGTGG	TGCGACAGGGGGTGG	2	1
TTAACTATAGTGCCG	TTAACTATAGTGCCG	1	1
GGACCGATCATCTCT	GGACCGATCATCTCT	1	1
CGAACGCCTTATAGT	CGAACGCCTTATAGT	2	1
TGCCACGGCAAATCT	TGCCACGGCAAATCT	1	1
GCTCACTATTTATTT	GCTCACTATTTATTT	3	1
GGATCATCCGTTGGA	GGATCATCCGTTGGA	1	1
ATAATAGGAAGGTTA	ATAATAGGAAGGTTA	1	1
GTTCCGCGCAGCACG	GTTCCGCGCAGCACG	1	1
TTTGTGAAAACTCAT	TTTGTGAAAACTCAT	4	1
GGTTATACAAAGTTT	GGTTATACAAAGTTT	3	1
TTCGAGCACTTGTTA	TTCGAGCACTTGTTA	1	1
CCAAGCGATAGCCAG	CCAAGCGATAGCCAG	1	1
TCAGGCGGGGGGGCG	TCAGGCGGGGGGGCG	2	1
GATAGCGCGCCTATT	GATAGCGCGCCTATT	1	1
CCAGGTCGGATGCCT	CCAGGTCGGATGCCT	1	1
ACTCAACGCTCATAC	ACTCAACGCTCATAC	3	1
AAAAGTTGGCGAAAC	AAAAGTTGGCGAAAC	1	1
GAGTGATGTGCGTCA	GAGTGATGTGCGTCA	4	1
TAAGGTGAATTGGTG	TAAGGTGAATTGGTG	2	1
GTAAAAATTCAATGA	GTAAAAATTCAATGA	1	1
GAAGTGTCTGACTGC	GAAGTGTCTGACTGC	1	1
TGTGGGATAGTTAGT	TGTGGGATAGTTAGT	1	1
AGACTCCTAGATATT	AGACTCCTAGATATT	1	1
CTATTATATTCCTAA	CTATTATATTCCTAA	2	1
ATTTCTTAAAATAAC	ATTTCTTAAAATAAC	2	1
GGAATGGGATACACG	GGAATGGGATACACG	1	1
CTTTGCTCTCTGCGT	CTTTGCTCTCTGCGT	1	1
TGTCTTGATTACTTT	TGTCTTGATTACTTT	1	1
CGAGTGCTGGAATAT	CGAGTGCTGGAATAT	1	1
GTCTGGACGCAAGGT	GTCTGGACGCAAGGT	1	1
GAATCCGTACTAGGT	GAATCCGTACTAGGT	1	1
GGATTACTATTTTAA	GGATTACTATTTTAA	1	1
TGGTTTTTAATGCCG	TGGTTTTTAATGCCG	1	1
ATACTGGTTTATATA	ATACTGGTTTATATA	2	1
TGAGGGGATCGTGGG	TGAGGGGATCGTGGG	1	1
GTTGTTTCTACATTG	GTTGTTTCTACATTG	2	1
TCATCGCTATTTTAT	TCATCGCTATTTTAT	1	1
GAGGACTACATTTTT	GAGGACTACATTTTT	3	1
CTTGTGGTATATTAG	CTTGTGGTATATTAG	1	1
GATTGTGGGTCGTAT	GATTGTGGGTCGTAT	1	1
CCGGATTACTTTGCT	CCGGATTACTTTGCT	1	1
CACTCGGTGATAGGC	CACTCGGTGATAGGC	2	1
TACTAAGCGTTATTT	TACTAAGCGTTATTT	1	1
TGATTGGGGCAGCAG	TGATTGGGGCAGCAG	1	1
CTAAGTTCGGTTGCG	CTAAGTTCGGTTGCG	1	1
TGTAAATGATATCAA	TGTAAATGATATCAA	1	1
CGGGTGATACAAAAT	CGGGTGATACAAAAT	1	1
TAAGAGCGTTTTGAA	TAAGAGCGTTTTGAA	1	1
CATCCTCTTCTAATC	CATCCTCTTCTAATC	1	1
GGAAGAGTGAGGGGG	GGAAGAGTGAGGGGG	1	1
TCGGGGGGAGGTGGG	TCGGGGGGAGGTGGG	1	1
GGTCGGGCAGTGTAG	GGTCGGGCAGTGTAG	2	1
TTTAGTCGGGCGTAA	TTTAGTCGGGCGTAA	1	1
TCACCAATCGAGCCT	TCACCAATCGAGCCT	1	1
CGTCAGGTATGTGGC	CGTCAGGTATGTGGC	1	1
CACCATTCACACTTA	CACCATTCACACTTA	2	1
CGATGTTTCATATGT	CGATGTTTCATATGT	1	1
ATACGCAAGTAAACT	ATACGCAAGTAAACT	1	1
GTACTAATCAGTTTT	GTACTAATCAGTTTT	1	1
TTGTTATTTGAATAT	TTGTTATTTGAATAT	1	1
CTAATTAAGATATAC	CTAATTAAGATATAC	1	1
GGGCGCCTGTTACTT	GGGCGCCTGTTACTT	1	1
TCTGGTGTTCATGGT	TCTGGTGTTCATGGT	1	1
CGAATACTACAGATA	CGAATACTACAGATA	2	1
TGGTAGTTCTAGAAT	TGGTAGTTCTAGAAT	1	1
TGAGGAGAAATCACG	TGAGGAGAAATCACG	1	1
GGAGTCGCTTTGGTG	GGAGTCGCTTTGGTG	2	1
CAAGGGTTTTAAGAA	CAAGGGTTTTAAGAA	1	1
AAATGTGTAAACATG	AAATGTGTAAACATG	1	1
GTCAATGAGACTACG	GTCAATGAGACTACG	4	1
TAAAGGGGCGCAGCG	TAAAGGGGCGCAGCG	3	1
CACACCCAGTTACAA	CACACCCAGTTACAA	1	1
CAGGGTTTCTATTCA	CAGGGTTTCTATTCA	1	1
CTACTACTCTTTCGA	CTACTACTCTTTCGA	1	1
ATATATTCTATATAC	ATATATTCTATATAC	1	1
AAGGGTGGATAGTGT	AAGGGTGGATAGTGT	1	1
TTCGGCGTCTGCGTG	TTCGGCGTCTGCGTG	1	1
AATAAGAGTTGACAA	AATAAGAGTTGACAA	1	1
TCTGCTCTCGTGTTG	TCTGCTCTCGTGTTG	2	1
ATTGTGTTTTAGCTA	ATTGTGTTTTAGCTA	1	1
CTAGCTACTTTCTAT	CTAGCTACTTTCTAT	1	1
ATCCACTTTCCCTTC	ATCCACTTTCCCTTC	2	1
GTGTATACCCTATGT	GTGTATACCCTATGT	1	1
TGTGGCTGGGGGCGT	TGTGGCTGGGGGCGT	1	1
TAAGCGAAGAAGTTA	TAAGCGAAGAAGTTA	2	1
CAACTTTCCAAATAT	CAACTTTCCAAATAT	1	1
CTCCTTACACCCATA	CTCCTTACACCCATA	1	1
CCTTCTCCATTTGTA	CCTTCTCCATTTGTA	2	1
CTTTTAACTAATTGA	CTTTTAACTAATTGA	1	1
TTCAGCTAAAACTTC	TTCAGCTAAAACTTC	1	1
ATACTAGAGTAATTG	ATACTAGAGTAATTG	1	1
GGATTGGAGGGGCGG	GGATTGGAGGGGCGG	2	1
AAAACTTTGGATCGG	AAAACTTTGGATCGG	2	1
GAGTCTACGCCTTCA	GAGTCTACGCCTTCA	1	1
TGCAAGGAGTTTGAT	TGCAAGGAGTTTGAT	2	1
TATAGAGTTGTCTAA	TATAGAGTTGTCTAA	2	1
TGGTTCATTGTGAAC	TGGTTCATTGTGAAC	2	1
TAAATAGAGCTATTA	TAAATAGAGCTATTA	1	1
CATATTCGCATATGG	CATATTCGCATATGG	1	1
TTTCCAAAAAGACAT	TTTCCAAAAAGACAT	1	1
TCGTTACTCTCGGTC	TCGTTACTCTCGGTC	1	1
GAGCAGTATAAGGGT	GAGCAGTATAAGGGT	1	1
AAAAACTATATCTTT	AAAAACTATATCTTT	1	1
TTTTCCATGTCTGGG	TTTTCCATGTCTGGG	1	1
GTATTATTTGGGAAA	GTATTATTTGGGAAA	1	1
GCTCAGTGATTTTTG	GCTCAGTGATTTTTG	2	1
CTGCTTTGCACGAGT	CTGCTTTGCACGAGT	1	1
GTTTCCCTTGAATTT	GTTTCCCTTGAATTT	1	1
GGTGGCGGGGGCCCG	GGTGGCGGGGGCCCG	1	1
GCTCTTTTATTCTCA	GCTCTTTTATTCTCA	2	1
TCACCACGCTAGTTT	TCACCACGCTAGTTT	1	1
GAGGAGCGGGGAGTG	GAGGAGCGGGGAGTG	1	1
GTTGGTTCTGATATT	GTTGGTTCTGATATT	2	1
CATCAACTGCATGGG	CATCAACTGCATGGG	1	1
GCGTATGTGCTTGGA	GCGTATGTGCTTGGA	1	1
TCATCGCAATTTCGG	TCATCGCAATTTCGG	1	1
GGAAAGGCTTTAATC	GGAAAGGCTTTAATC	2	1
GAGGCTAATACACAC	GAGGCTAATACACAC	2	1
AGATGGACTTCCTTT	AGATGGACTTCCTTT	1	1
AAGTCAGTTAGAACA	AAGTCAGTTAGAACA	1	1
ATCCGCAACCGTGTT	ATCCGCAACCGTGTT	1	1
ATTAATCTAGATTGG	ATTAATCTAGATTGG	1	1
TGAAAATTATCACAA	TGAAAATTATCACAA	1	1
TGTGCCAGTTCTACC	TGTGCCAGTTCTACC	1	1
ATACTCTAAAGTTTG	ATACTCTAAAGTTTG	1	1
CGGGTCCGGCAGATT	CGGGTCCGGCAGATT	1	1
ATTGAAGCTCAATCA	ATTGAAGCTCAATCA	1	1
ATAGGGATTTTATTT	ATAGGGATTTTATTT	1	1
GTCTTTGTTATTTTT	GTCTTTGTTATTTTT	1	1
GCTTATAATAAAGTG	GCTTATAATAAAGTG	3	1
TGTTACTGTGGGAAA	TGTTACTGTGGGAAA	2	1
GGTAATAAGACGGGG	GGTAATAAGACGGGG	3	1
TCGGGCGTGGGGGGG	TCGGGCGTGGGGGGG	2	1
CAAGAAGGGCACCGG	CAAGAAGGGCACCGG	1	1
CTAGTAGGCGGTTGT	CTAGTAGGCGGTTGT	1	1
TCAAGGAGACTGGAT	TCAAGGAGACTGGAT	1	1
TTAGCGTGTCCTTAA	TTAGCGTGTCCTTAA	1	1
CAAATATCGCTGATT	CAAATATCGCTGATT	1	1
TAGGTCGTGGTGATG	TAGGTCGTGGTGATG	1	1
GACTTTGAACAAGAT	GACTTTGAACAAGAT	1	1
GGGGGGAGCAGCTGG	GGGGGGAGCAGCTGG	1	1
ACTCGTGGACAATTG	ACTCGTGGACAATTG	2	1
TAACTCCTTTAAACT	TAACTCCTTTAAACT	1	1
CTATTACATCAGCTG	CTATTACATCAGCTG	1	1
GGGTCGTAGGACGTG	GGGTCGTAGGACGTG	3	1
GCGCCTGTACAGCCT	GCGCCTGTACAGCCT	4	1
TCACATCTAGTGCCT	TCACATCTAGTGCCT	1	1
GTTTTTGTTGATTTC	GTTTTTGTTGATTTC	2	1
TTCGTGTAATTTTAT	TTCGTGTAATTTTAT	1	1
CGGATTATCACGATC	CGGATTATCACGATC	1	1
CAACGTTGGGAATCT	CAACGTTGGGAATCT	1	1
AGGTGCAGGTATTAA	AGGTGCAGGTATTAA	1	1
TATTATAGGAAGTTT	TATTATAGGAAGTTT	1	1
TCCATCCATTCAATC	TCCATCCATTCAATC	1	1
GTAACTGTACACATC	GTAACTGTACACATC	1	1
TTTCAAGATGCTGTT	TTTCAAGATGCTGTT	1	1
TGTTCGGTTAGTGTG	TGTTCGGTTAGTGTG	2	1
TCCAAGGATTAATTT	TCCAAGGATTAATTT	5	1
GCGTCTCTCTTGGTC	GCGTCTCTCTTGGTC	2	1
CTTCTGCTTTTACTC	CTTCTGCTTTTACTC	1	1
GCTATATATATCTCC	GCTATATATATCTCC	1	1
GTTTCGACGATTATT	GTTTCGACGATTATT	1	1
CGATACACAGCTTCA	CGATACACAGCTTCA	1	1
CTCGGTATACTTTGG	CTCGGTATACTTTGG	1	1
ATGTTTCTGTAATCT	ATGTTTCTGTAATCT	2	1
CTAGGAAATCCTTTT	CTAGGAAATCCTTTT	1	1
GATAACGTGGACAAT	GATAACGTGGACAAT	1	1
TATAGGACCTTGTTT	TATAGGACCTTGTTT	1	1
CAGCGTATCAGCGTA	CAGCGTATCAGCGTA	1	1
GTGCGGCGGCGGCGG	GTGCGGCGGCGGCGG	1	1
CTCGTCGTAGATCGG	CTCGTCGTAGATCGG	1	1
CCTGCTTTTTGATGC	CCTGCTTTTTGATGC	1	1
GGGGATTCCCGTATT	GGGGATTCCCGTATT	1	1
TGGTTGGCGGGGACG	TGGTTGGCGGGGACG	1	1
TGACTCAATTTCTGA	TGACTCAATTTCTGA	1	1
GGGGGGCGAGGGTAT	GGGGGGCGAGGGTAT	2	1
TATGTTAGTAGAATG	TATGTTAGTAGAATG	1	1
TCCAGCTATAAATTC	TCCAGCTATAAATTC	2	1
CCAACTTTACCTGGG	CCAACTTTACCTGGG	2	1
TGGATGGTGGGTCGG	TGGATGGTGGGTCGG	2	1
CGCGAACACGGCACA	CGCGAACACGGCACA	1	1
TTCTCCTTTGTAAAA	TTCTCCTTTGTAAAA	1	1
AAAGTGACGGATGGC	AAAGTGACGGATGGC	1	1
CTTGATCGCTCGGCA	CTTGATCGCTCGGCA	1	1
ACCGTGCGATCTGAT	ACCGTGCGATCTGAT	1	1
CACATTTAACTCCCG	CACATTTAACTCCCG	1	1
TGTCGAATTATGGTT	TGTCGAATTATGGTT	1	1
TACATATTACTACTC	TACATATTACTACTC	1	1
GGAACTCAAATCGCG	GGAACTCAAATCGCG	1	1
GAAACTGGCTGCGGT	GAAACTGGCTGCGGT	1	1
TTCGTCGGACTATAA	TTCGTCGGACTATAA	1	1
GGTACTTGTTTAAGG	GGTACTTGTTTAAGG	2	1
TCCTGCCCATGCATC	TCCTGCCCATGCATC	2	1
GACGCACATGCTCAC	GACGCACATGCTCAC	1	1
GTACTTTATTTGTCA	GTACTTTATTTGTCA	1	1
AAGCCGTACGGGAAA	AAGCCGTACGGGAAA	1	1
AACTTTGTCAAATCT	AACTTTGTCAAATCT	1	1
ATTACAAATCCAGCA	ATTACAAATCCAGCA	1	1
CCTCTCTCGTTTAAT	CCTCTCTCGTTTAAT	1	1
TGTGCTGATCATACA	TGTGCTGATCATACA	1	1
GAACCTCATTTTCCG	GAACCTCATTTTCCG	1	1
TATTGGTGATTTGTC	TATTGGTGATTTGTC	3	1
TTATCATGGGTTTTT	TTATCATGGGTTTTT	1	1
ACATCTTCCTGTTTA	ACATCTTCCTGTTTA	1	1
TCACTGGATCGGGGG	TCACTGGATCGGGGG	1	1
CGCGTACACTCTAAT	CGCGTACACTCTAAT	4	1
GAGGCAGAATAGTAG	GAGGCAGAATAGTAG	1	1
TATTCTAATGATTGA	TATTCTAATGATTGA	1	1
ACCACATTAAGTCTT	ACCACATTAAGTCTT	1	1
ACCCCTGCGATTGGA	ACCCCTGCGATTGGA	2	1
TGATATTAGTTTATA	TGATATTAGTTTATA	2	1
ACATACTTTGTCTAT	ACATACTTTGTCTAT	1	1
TTATTCTTATCTTAC	TTATTCTTATCTTAC	1	1
GATACTGCGTTCACC	GATACTGCGTTCACC	1	1
TTTATACTCATTCCT	TTTATACTCATTCCT	1	1
GTCGGGCGGCTGGCT	GTCGGGCGGCTGGCT	1	1
AGAGTCAAGACGGAG	AGAGTCAAGACGGAG	1	1
ATTGAATCTGACTCG	ATTGAATCTGACTCG	1	1
AAACGCCTTCGCGTG	AAACGCCTTCGCGTG	1	1
TTTTCCAGCGCCCTA	TTTTCCAGCGCCCTA	1	1
TTAGGTTCTGCAAGT	TTAGGTTCTGCAAGT	1	1
GTTTGGTGTAAGCTA	GTTTGGTGTAAGCTA	2	1
TGGGAATTATCCAAT	TGGGAATTATCCAAT	1	1
ATGATTATCGGCTTT	ATGATTATCGGCTTT	6	1
CCCTGCCGCCGCTTA	CCCTGCCGCCGCTTA	1	1
TTTCCAACGAATTCA	TTTCCAACGAATTCA	1	1
TTATGGGTCGGTTTC	TTATGGGTCGGTTTC	1	1
AGGGATCCTCCATTT	AGGGATCCTCCATTT	1	1
TTGCGAGGTTGTAGG	TTGCGAGGTTGTAGG	1	1
GTTGGCCATCATGAA	GTTGGCCATCATGAA	1	1
GTAGATAAGCATACA	GTAGATAAGCATACA	1	1
TATATCCATGGTTTT	TATATCCATGGTTTT	2	1
TTTAAGAGATCCTCA	TTTAAGAGATCCTCA	2	1
ATATCACCTCAAAGG	ATATCACCTCAAAGG	2	1
ACCGGGAACCTGCAT	ACCGGGAACCTGCAT	1	1
GAGAGCATGCTGCAA	GAGAGCATGCTGCAA	1	1
CGAAATAGTACTGTT	CGAAATAGTACTGTT	1	1
CGACAGAACATCCGG	CGACAGAACATCCGG	1	1
CGAATCGGTATGGGT	CGAATCGGTATGGGT	1	1
AACTAAGGCATTATG	AACTAAGGCATTATG	1	1
CGTAGGCTTTTAGCT	CGTAGGCTTTTAGCT	1	1
AGTGTGATCGATCTT	AGTGTGATCGATCTT	1	1
TTACAAAATATATGT	TTACAAAATATATGT	1	1
CTTCTGTATGCAAAT	CTTCTGTATGCAAAT	1	1
GAACAATTATTGGGT	GAACAATTATTGGGT	1	1
AAAACTAAACTATGT	AAAACTAAACTATGT	1	1
TGCAAAAACCCTATT	TGCAAAAACCCTATT	1	1
ATCTAATTTAAAGTA	ATCTAATTTAAAGTA	1	1
AATGCTACACTCATA	AATGCTACACTCATA	1	1
GCGGGGATAATTTCA	GCGGGGATAATTTCA	1	1
TTCTCCAGTATTGTT	TTCTCCAGTATTGTT	1	1
CATATTTTCGGAAAA	CATATTTTCGGAAAA	1	1
ACGTAGGGTATTCGA	ACGTAGGGTATTCGA	1	1
TTCTTGTATCTAATT	TTCTTGTATCTAATT	1	1
CGTAATTGGACGCAG	CGTAATTGGACGCAG	1	1
TTCAGTTTGTTGACT	TTCAGTTTGTTGACT	1	1
GCCGCTATTCACTGC	GCCGCTATTCACTGC	1	1
ATGGAGCGTCCTAGG	ATGGAGCGTCCTAGG	1	1
AATAATCATATGGCA	AATAATCATATGGCA	1	1
TTGGCAGGAGAGGGT	TTGGCAGGAGAGGGT	2	1
GTTCATCGTCTTGCT	GTTCATCGTCTTGCT	1	1
GCATTGATTATTTTC	GCATTGATTATTTTC	1	1
TGTGTATGGGTAAAT	TGTGTATGGGTAAAT	1	1
AATCCATTTGACCCC	AATCCATTTGACCCC	1	1
TTAAGCTTAAGTCGT	TTAAGCTTAAGTCGT	1	1
GGCGTGGCGCGGTTG	GGCGTGGCGCGGTTG	1	1
TGAACTCGCGTTGTA	TGAACTCGCGTTGTA	1	1
GCGGTGAAGGTTTAA	GCGGTGAAGGTTTAA	1	1
TGCGAGTGCGATTCC	TGCGAGTGCGATTCC	1	1
GGGAGGGTGTGACGG	GGGAGGGTGTGACGG	1	1
CGATGGCATTTTAAA	CGATGGCATTTTAAA	1	1
AAAACAGTAAGTCCA	AAAACAGTAAGTCCA	1	1
TAATATAGGATCGTT	TAATATAGGATCGTT	1	1
CACTGACGTGCCGTA	CACTGACGTGCCGTA	1	1
CATCTTGTAATTCAA	CATCTTGTAATTCAA	1	1
TAACGTGCACTGCTG	TAACGTGCACTGCTG	1	1
ATCGATCGTGAGCTA	ATCGATCGTGAGCTA	1	1
GGGGGGGGGGGAGAG	GGGGGGGGGGGAGAG	1	1
GATGGTGTGGAGGGG	GATGGTGTGGAGGGG	1	1
TGTGGTCAGGGTTTG	TGTGGTCAGGGTTTG	1	1
CTCAGATACTGGGCA	CTCAGATACTGGGCA	1	1
TTAGTGTTATCGTGC	TTAGTGTTATCGTGC	1	1
CATGTATGGAACTCT	CATGTATGGAACTCT	1	1
TTTGGGACAAGTTGA	TTTGGGACAAGTTGA	2	1
TTGACTTTATTATGA	TTGACTTTATTATGA	1	1
CATGAGGGGTCAAGG	CATGAGGGGTCAAGG	1	1
GTCTTTGTTAGTTTT	GTCTTTGTTAGTTTT	2	1
CATCGGTCGTCCTCC	CATCGGTCGTCCTCC	2	1
CATCGTAGACCCTCT	CATCGTAGACCCTCT	1	1
TAATAGTGAACAAAG	TAATAGTGAACAAAG	2	1
CAATTCTTGGCGACC	CAATTCTTGGCGACC	1	1
CCCTATCATGATTGT	CCCTATCATGATTGT	2	1
GGTACCTTTACGTCT	GGTACCTTTACGTCT	2	1
CATACACCAATATCT	CATACACCAATATCT	1	1
AGGTATACGACGTAG	AGGTATACGACGTAG	2	1
TACTCATCACTACAA	TACTCATCACTACAA	1	1
AACATAAATACTTTC	AACATAAATACTTTC	1	1
GCAAAATCCGCGGAA	GCAAAATCCGCGGAA	1	1
CAAATTGAACCCTGT	CAAATTGAACCCTGT	2	1
GCGATAAATATATAT	GCGATAAATATATAT	1	1
TAAATACATAACCTT	TAAATACATAACCTT	1	1
GCGTGCATTATTTCA	GCGTGCATTATTTCA	1	1
TTTCGCGTAATGTGG	TTTCGCGTAATGTGG	1	1
TAAATGTTTGTATCA	TAAATGTTTGTATCA	2	1
ATCTGATCATCGGAA	ATCTGATCATCGGAA	1	1
GTTAAGTCTGATTTC	GTTAAGTCTGATTTC	2	1
CAAGGATCTGAAGTT	CAAGGATCTGAAGTT	2	1
AACTGCTCCACGTCA	AACTGCTCCACGTCA	1	1
TACGGCGTAGGGTGG	TACGGCGTAGGGTGG	1	1
GTCTTGTAGCCCTTT	GTCTTGTAGCCCTTT	2	1
TGAGTACATAAAAAC	TGAGTACATAAAAAC	1	1
GTTAATAGGGGGATA	GTTAATAGGGGGATA	1	1
GTGATGGTGAAGGCA	GTGATGGTGAAGGCA	1	1
CCTATTTAACTGATT	CCTATTTAACTGATT	1	1
CTGTTAAAATTGGCT	CTGTTAAAATTGGCT	1	1
CAACACTCTGCGTAT	CAACACTCTGCGTAT	1	1
ACTGCTGTGACGTTG	ACTGCTGTGACGTTG	2	1
TAATTGATGTACGCA	TAATTGATGTACGCA	1	1
ATTAGTGCTAGCTAC	ATTAGTGCTAGCTAC	1	1
ATTATTAGTAGGGAG	ATTATTAGTAGGGAG	2	1
CTAAACTAGCATTTT	CTAAACTAGCATTTT	2	1
TGCATGCACCTCAGT	TGCATGCACCTCAGT	1	1
GTCGGTGGGGACTGT	GTCGGTGGGGACTGT	2	1
TGGTCGGCTATATCT	TGGTCGGCTATATCT	1	1
AACCAAGAGAACGAT	AACCAAGAGAACGAT	1	1
GTAATATCTTTGTTT	GTAATATCTTTGTTT	1	1
TGGTTTACCTTGCTT	TGGTTTACCTTGCTT	1	1
TCCGTGAGCAATGTG	TCCGTGAGCAATGTG	1	1
GAGTATTATAGAGTT	GAGTATTATAGAGTT	1	1
ACGCTTACCTTACTC	ACGCTTACCTTACTC	1	1
GGTCACGGAGCGAGA	GGTCACGGAGCGAGA	1	1
ACGCAAGTTCCTACA	ACGCAAGTTCCTACA	1	1
TATGTCCAAATACAC	TATGTCCAAATACAC	1	1
TTCAGTGGTGCCATT	TTCAGTGGTGCCATT	1	1
AAGAATTCTATTCGT	AAGAATTCTATTCGT	1	1
CCTGAGGAGCCGAGT	CCTGAGGAGCCGAGT	2	1
TGATCAACCCTAATC	TGATCAACCCTAATC	1	1
TGGCGTCGGGGACAA	TGGCGTCGGGGACAA	1	1
AACCGAGGCGGGGGG	AACCGAGGCGGGGGG	1	1
TATGTCCTGCAATCG	TATGTCCTGCAATCG	2	1
AAAAGATTAGAAGTG	AAAAGATTAGAAGTG	1	1
CTATGTGTTAAATTA	CTATGTGTTAAATTA	2	1
GAGAGCTGAGGGGTG	GAGAGCTGAGGGGTG	1	1
TCATGCGATGAGGGA	TCATGCGATGAGGGA	1	1
AAAGGGGGTGCTCGA	AAAGGGGGTGCTCGA	1	1
CATGAAAGAAAATCT	CATGAAAGAAAATCT	2	1
CAGTAGCGAAGATCT	CAGTAGCGAAGATCT	1	1
TATATGGCTTTAGCG	TATATGGCTTTAGCG	1	1
TTGTGGCATGCGGGG	TTGTGGCATGCGGGG	1	1
TTAGTATTCAGAATG	TTAGTATTCAGAATG	1	1
ATGTGGATGGTGGGG	ATGTGGATGGTGGGG	1	1
CAAATTTGTTCATTC	CAAATTTGTTCATTC	1	1
CATCTCCAATGTTCT	CATCTCCAATGTTCT	1	1
GATGTTTACGCTTCT	GATGTTTACGCTTCT	2	1
TCTAGTTTCGCTATC	TCTAGTTTCGCTATC	1	1
AATTGATGCCATGAT	AATTGATGCCATGAT	1	1
CATAAATCATCTGGT	CATAAATCATCTGGT	1	1
TGTATGAGTGTGATA	TGTATGAGTGTGATA	1	1
ACTGATTTTTAAACT	ACTGATTTTTAAACT	2	1
AACGTAAATGGTTAA	AACGTAAATGGTTAA	1	1
AGGAATTAAACAAAA	AGGAATTAAACAAAA	1	1
AACGGTATAATGTAT	AACGGTATAATGTAT	2	1
CCTTGGCCATTCGTG	CCTTGGCCATTCGTG	1	1
TACAGGTACCAAATA	TACAGGTACCAAATA	2	1
ACCGGAAGTGTGAGT	ACCGGAAGTGTGAGT	1	1
AAGTTCTAATTCTGC	AAGTTCTAATTCTGC	1	1
ACTATGAGAGTTGAC	ACTATGAGAGTTGAC	1	1
TATTTCGAGCGATTG	TATTTCGAGCGATTG	1	1
CGAGTTGTTAAATCC	CGAGTTGTTAAATCC	2	1
TTACAATTTCCCGCC	TTACAATTTCCCGCC	3	1
ACAACTCATTTATGC	ACAACTCATTTATGC	1	1
CACGGTATCTCAATA	CACGGTATCTCAATA	1	1
ATCAGATCGTTCTCT	ATCAGATCGTTCTCT	1	1
ATAATACCGGCCTTA	ATAATACCGGCCTTA	2	1
CGTACATAGGTATCT	CGTACATAGGTATCT	2	1
GCCCAATTTCCAATA	GCCCAATTTCCAATA	1	1
TTGTCTAATAATATA	TTGTCTAATAATATA	1	1
GCCAAAGACATTAAC	GCCAAAGACATTAAC	1	1
TGTTTAACAGTCTAA	TGTTTAACAGTCTAA	1	1
ATTTTTTGTCTATGG	ATTTTTTGTCTATGG	1	1
ATTGTATGGGTTCGA	ATTGTATGGGTTCGA	1	1
AAGTTCAACTCTCCG	AAGTTCAACTCTCCG	1	1
GGATGTGGCGTAGGC	GGATGTGGCGTAGGC	1	1
CGAGTGCTCCGTCAT	CGAGTGCTCCGTCAT	2	1
CCCGAACCATTAACA	CCCGAACCATTAACA	1	1
TTCTTCGCGACACCA	TTCTTCGCGACACCA	1	1
CGCCTGCGTGCGCGT	CGCCTGCGTGCGCGT	1	1
TGCGGTGAGTGGTAA	TGCGGTGAGTGGTAA	1	1
GTTGAGCTGGTAGGG	GTTGAGCTGGTAGGG	4	1
TAAATCGCAATTTCT	TAAATCGCAATTTCT	1	1
ACGAACCGCGTTGTC	ACGAACCGCGTTGTC	3	1
ATGGGTGATTCGCTA	ATGGGTGATTCGCTA	2	1
TAGAGTGATTATCGC	TAGAGTGATTATCGC	2	1
ACCTCTAAGTGCTAT	ACCTCTAAGTGCTAT	1	1
GAGATCGGGTGAGCG	GAGATCGGGTGAGCG	1	1
TGAGTGGCATCGGGG	TGAGTGGCATCGGGG	1	1
GAGGGCGCTTTGCGT	GAGGGCGCTTTGCGT	1	1
GCAGCAGTCTGGCTG	GCAGCAGTCTGGCTG	1	1
TTCTGTACATGTGCC	TTCTGTACATGTGCC	1	1
ATATTTCTGTACCTA	ATATTTCTGTACCTA	1	1
TTTGTGCATGACACA	TTTGTGCATGACACA	1	1
GGGGCGGAGGGCGGG	GGGGCGGAGGGCGGG	2	1
AATATGGTACGTGCA	AATATGGTACGTGCA	1	1
GTGCTCATGGATTGG	GTGCTCATGGATTGG	1	1
TGTGGGATGTTGGTT	TGTGGGATGTTGGTT	2	1
CAGCGTCTCGCCTTG	CAGCGTCTCGCCTTG	1	1
ATATGTTCGAGGTGG	ATATGTTCGAGGTGG	1	1
CTTCTGGGTCTACCT	CTTCTGGGTCTACCT	1	1
GGTCCACGTTCAGCC	GGTCCACGTTCAGCC	2	1
TTACAGGCTGTAAGC	TTACAGGCTGTAAGC	1	1
CACGCTCAGTTTTAC	CACGCTCAGTTTTAC	1	1
AAAAATTATACCTTC	AAAAATTATACCTTC	1	1
CATACAAGATCGGTT	CATACAAGATCGGTT	2	1
TACTTGCAATTCAAT	TACTTGCAATTCAAT	1	1
GCGCTTCTAATTTAG	GCGCTTCTAATTTAG	1	1
TTAGTTTTATGCATG	TTAGTTTTATGCATG	1	1
GTAATTACAAATGAA	GTAATTACAAATGAA	2	1
TCAGGTTTGCATCAT	TCAGGTTTGCATCAT	1	1
AATCTCAGTCCCTTT	AATCTCAGTCCCTTT	1	1
TTGTCATTGGTTGTC	TTGTCATTGGTTGTC	1	1
TTGATTCCATAAAAC	TTGATTCCATAAAAC	3	1
CTCAGGTTCTAAGGT	CTCAGGTTCTAAGGT	1	1
AGGAGTTGCAGCAAG	AGGAGTTGCAGCAAG	1	1
CATGCACTTTCAACT	CATGCACTTTCAACT	2	1
GTTGGTTAACACGTG	GTTGGTTAACACGTG	1	1
TGACTTCTTTTACTT	TGACTTCTTTTACTT	2	1
TCTACTAAATAGGGA	TCTACTAAATAGGGA	1	1
GGGCAGCGTGTGGAG	GGGCAGCGTGTGGAG	1	1
TTCTCATACCTACGT	TTCTCATACCTACGT	1	1
CTCTCATGTCAGTTA	CTCTCATGTCAGTTA	2	1
AAGCGGCGGACGAGA	AAGCGGCGGACGAGA	1	1
TTAATTGTTTACTAA	TTAATTGTTTACTAA	1	1
TGAGACCACTCTTAT	TGAGACCACTCTTAT	3	1
ATGAGATGGCAATGG	ATGAGATGGCAATGG	2	1
GCCGGGGTGGGGGCG	GCCGGGGTGGGGGCG	1	1
GTGCTGCAGGTGGAA	GTGCTGCAGGTGGAA	1	1
TCTTATTGGTAACAA	TCTTATTGGTAACAA	1	1
TCATTCAGCATCGAT	TCATTCAGCATCGAT	1	1
GCCGAAGGTGTGTGG	GCCGAAGGTGTGTGG	1	1
TAAACATTCCAGACC	TAAACATTCCAGACC	1	1
ATAGTGTAAACTTAT	ATAGTGTAAACTTAT	1	1
TCACCGTGTTCTGAG	TCACCGTGTTCTGAG	1	1
CGACCTGATATCCTT	CGACCTGATATCCTT	1	1
TCCCAACTCTATTGC	TCCCAACTCTATTGC	1	1
GTATGTGACATGTGT	GTATGTGACATGTGT	1	1
CGCGCGAGTGAGTAA	CGCGCGAGTGAGTAA	2	1
CGTCTTATTTATATG	CGTCTTATTTATATG	1	1
AGAAAGGGTATACGT	AGAAAGGGTATACGT	1	1
GGGGTTACATATAAT	GGGGTTACATATAAT	1	1
TCTCCAAGATTGAGA	TCTCCAAGATTGAGA	1	1
CGACGTTGCACTTAC	CGACGTTGCACTTAC	1	1
TACTCTATTATCGAT	TACTCTATTATCGAT	1	1
TCTATCACCTCAGGG	TCTATCACCTCAGGG	1	1
AATCTCTACATTCTG	AATCTCTACATTCTG	1	1
GTTGCCATACACCTT	GTTGCCATACACCTT	1	1
ATGTTTTGATAACGT	ATGTTTTGATAACGT	1	1
TACAATGCAAATAAC	TACAATGCAAATAAC	1	1
GTAAGCTGTAATCCG	GTAAGCTGTAATCCG	1	1
ATAACGGGGTAATAC	ATAACGGGGTAATAC	1	1
AGTTCGGTCGCCGAC	AGTTCGGTCGCCGAC	1	1
GATATTACTAATGGT	GATATTACTAATGGT	1	1
TTTTAGACTTCTATT	TTTTAGACTTCTATT	1	1
TCGTTCGTAAATATC	TCGTTCGTAAATATC	1	1
TAATGATATCCCTAT	TAATGATATCCCTAT	1	1
CGCGAGCTAAGCGGG	CGCGAGCTAAGCGGG	1	1
CTAGTGCATCCTTGT	CTAGTGCATCCTTGT	3	1
TCAAATCTGACACTG	TCAAATCTGACACTG	2	1
CTTAATTATCGTAAT	CTTAATTATCGTAAT	1	1
AGCCATTCACGTCCT	AGCCATTCACGTCCT	1	1
TTCGTTGAATCCATT	TTCGTTGAATCCATT	1	1
CGAGGGGGGGGCGCG	CGAGGGGGGGGCGCG	1	1
TCTTGCGATTAGATC	TCTTGCGATTAGATC	1	1
GTAACTTTAGTGACA	GTAACTTTAGTGACA	1	1
AAATCCGTCACTCTT	AAATCCGTCACTCTT	1	1
ACAATCGTCTAACCC	ACAATCGTCTAACCC	1	1
TGATGGTTCTTGTTA	TGATGGTTCTTGTTA	2	1
TTAGGTTACGTTATT	TTAGGTTACGTTATT	1	1
ACTCCAGGCTGTTGC	ACTCCAGGCTGTTGC	2	1
TACAACGCAGTTTCT	TACAACGCAGTTTCT	1	1
AATCCAGTACATCTA	AATCCAGTACATCTA	1	1
GGAAAAAGGTAATCA	GGAAAAAGGTAATCA	1	1
ATACATGACTTATTC	ATACATGACTTATTC	1	1
TTAGTATTAATAAAT	TTAGTATTAATAAAT	1	1
ATGTCTTTTTTGAGA	ATGTCTTTTTTGAGA	1	1
CTTTGTTGTGTCCTG	CTTTGTTGTGTCCTG	2	1
TTGGGATCACCTGGC	TTGGGATCACCTGGC	1	1
GGAATCAGGGGTCCT	GGAATCAGGGGTCCT	1	1
CTTGGTACGGCTTAT	CTTGGTACGGCTTAT	1	1
ATACTTTAGTAGAAT	ATACTTTAGTAGAAT	1	1
CAGTGTTAACAACTG	CAGTGTTAACAACTG	2	1
ATTGGCGCGTCAATA	ATTGGCGCGTCAATA	1	1
TGCGTGTATGGGGTG	TGCGTGTATGGGGTG	1	1
CATTTTGCATTGGTT	CATTTTGCATTGGTT	2	1
TATAGAGATATCACT	TATAGAGATATCACT	1	1
GATAATCTCAATGCT	GATAATCTCAATGCT	1	1
GTTTGAGAGCTAGGG	GTTTGAGAGCTAGGG	1	1
CCGCGTATGTAGTTA	CCGCGTATGTAGTTA	1	1
AACGGTACCTGGTGC	AACGGTACCTGGTGC	1	1
TAGGGGTCAGACATT	TAGGGGTCAGACATT	1	1
AAAGTATAAAGTGTC	AAAGTATAAAGTGTC	1	1
TGTTAATGGCTGGCA	TGTTAATGGCTGGCA	1	1
TATCCTCTATATCCG	TATCCTCTATATCCG	1	1
TCTTTAAAAACCACA	TCTTTAAAAACCACA	1	1
AGGTTAATCGGTTAC	AGGTTAATCGGTTAC	1	1
TTTCGTTAAATTGAT	TTTCGTTAAATTGAT	1	1
AAGACTCGTTCGCTA	AAGACTCGTTCGCTA	1	1
ACATGGAATCTAAAA	ACATGGAATCTAAAA	1	1
CCTTTCGCTATTGAC	CCTTTCGCTATTGAC	1	1
TCCGGTCGTGGTTCC	TCCGGTCGTGGTTCC	1	1
TTCAGTTTAACCGCT	TTCAGTTTAACCGCT	2	1
ATGTAGAGGTTTGGT	ATGTAGAGGTTTGGT	1	1
ACATGACTCTATGGT	ACATGACTCTATGGT	1	1
ACTGATAAGTCTGCT	ACTGATAAGTCTGCT	1	1
TAGTCGTTATTCTCG	TAGTCGTTATTCTCG	1	1
TGCTTTCTCTCGAGT	TGCTTTCTCTCGAGT	1	1
GTTCAGAATAACATC	GTTCAGAATAACATC	1	1
TTCGTTTCACTGCGT	TTCGTTTCACTGCGT	1	1
TCCGGTTAATGTCCC	TCCGGTTAATGTCCC	2	1
CAATCCTTAACATAC	CAATCCTTAACATAC	1	1
CGGGATCGGATAGTG	CGGGATCGGATAGTG	1	1
AGTAAATTTATAGGA	AGTAAATTTATAGGA	1	1
GATTTCATCTTCCAT	GATTTCATCTTCCAT	1	1
TATAGACATTAGTCC	TATAGACATTAGTCC	1	1
GTGCTCTAAAATTTA	GTGCTCTAAAATTTA	1	1
ATTTTGAGGTCAGGG	ATTTTGAGGTCAGGG	1	1
TTACCAAGCATTATT	TTACCAAGCATTATT	1	1
TTCTGACTAGCTGAG	TTCTGACTAGCTGAG	2	1
CAGTGTCGTTGGGAC	CAGTGTCGTTGGGAC	2	1
TTATTTGTCGGCGCC	TTATTTGTCGGCGCC	1	1
GCTGGGAGAGCGACG	GCTGGGAGAGCGACG	1	1
GCCGAAGCACTTTCC	GCCGAAGCACTTTCC	2	1
TTTTTTTTAACTTGT	TTTTTTTTAACTTGT	3	1
TAAGCGGTGACACAT	TAAGCGGTGACACAT	1	1
GTCTTAGGATGTTCT	GTCTTAGGATGTTCT	1	1
CAATCTCGGTCCATT	CAATCTCGGTCCATT	1	1
ACGATTGTTTCACAA	ACGATTGTTTCACAA	2	1
TCCCACCTTTCTTTT	TCCCACCTTTCTTTT	3	1
TGACATTACCAGCGA	TGACATTACCAGCGA	1	1
TAATCGGATGGATCT	TAATCGGATGGATCT	1	1
CCGTGGGGAGGAGGG	CCGTGGGGAGGAGGG	1	1
GTCGTTTTAATCTAA	GTCGTTTTAATCTAA	1	1
GGGATTTTAAGTTAC	GGGATTTTAAGTTAC	1	1
CATCATTAATCTTTG	CATCATTAATCTTTG	1	1
TATTGTAGAGGCCGA	TATTGTAGAGGCCGA	1	1
CATTCGGTACCTATC	CATTCGGTACCTATC	1	1
CTAAACTCATGCATT	CTAAACTCATGCATT	1	1
CTATTCTAAGATAGT	CTATTCTAAGATAGT	1	1
CGGCTGGGGGGTGAA	CGGCTGGGGGGTGAA	2	1
GATCATAGTCTACAC	GATCATAGTCTACAC	1	1
TAACTCCCTTTGTCG	TAACTCCCTTTGTCG	1	1
TTTGGGCTTCCAATT	TTTGGGCTTCCAATT	1	1
AGACCAAGCGAATGA	AGACCAAGCGAATGA	2	1
GCTTGTATCTAACTG	GCTTGTATCTAACTG	1	1
TGATTAGGCTAATCT	TGATTAGGCTAATCT	1	1
ATGTAGACCTATATC	ATGTAGACCTATATC	1	1
TAGTCGTGATGGAAG	TAGTCGTGATGGAAG	1	1
TTCTTATTGCTAAGT	TTCTTATTGCTAAGT	1	1
GAAGTTTCTTCTTGC	GAAGTTTCTTCTTGC	1	1
GTGCTCTCAATTTTG	GTGCTCTCAATTTTG	1	1
CGCGGCAAGACGGGG	CGCGGCAAGACGGGG	1	1
GTAGTACTTGGCTAG	GTAGTACTTGGCTAG	1	1
CGCTCATACTCTATA	CGCTCATACTCTATA	1	1
ATTTTGATTGCTCCG	ATTTTGATTGCTCCG	1	1
TTTTTTCAATTTAGC	TTTTTTCAATTTAGC	1	1
CAATACGGATTAATA	CAATACGGATTAATA	1	1
GGAGCATGGGTGGAT	GGAGCATGGGTGGAT	2	1
TGACTATGATAGCGG	TGACTATGATAGCGG	1	1
GAATAACGTGTTTGA	GAATAACGTGTTTGA	1	1
GCCGTGCCGGGTGAG	GCCGTGCCGGGTGAG	1	1
AATGGGTTCGTTTGG	AATGGGTTCGTTTGG	1	1
CTCCTGAGTGCCGTA	CTCCTGAGTGCCGTA	1	1
TTCATGTTTTCACAC	TTCATGTTTTCACAC	1	1
AGTTCACGCGTATTC	AGTTCACGCGTATTC	1	1
GACATTCGCCTCAAA	GACATTCGCCTCAAA	1	1
TACATATTTCGAAGT	TACATATTTCGAAGT	2	1
ATCTGGGTCACATAC	ATCTGGGTCACATAC	3	1
GGTCTCCTGGCATTA	GGTCTCCTGGCATTA	1	1
TGTCGAAATAGCTCT	TGTCGAAATAGCTCT	1	1
ATTTGTGATATTAAA	ATTTGTGATATTAAA	1	1
CGTGCCTCTTCCACT	CGTGCCTCTTCCACT	1	1
TCGGATAGTTTGACC	TCGGATAGTTTGACC	1	1
ACATTACCGTCTTCG	ACATTACCGTCTTCG	1	1
GGGCTGCAGGTGGAA	GGGCTGCAGGTGGAA	1	1
AATAATAGGTACTGA	AATAATAGGTACTGA	1	1
GTGGGGCGGGAAGGT	GTGGGGCGGGAAGGT	1	1
ATCTGCTCTACTATT	ATCTGCTCTACTATT	1	1
CCTTTCTTTTACAAT	CCTTTCTTTTACAAT	2	1
TTTGTAACTCAGAGG	TTTGTAACTCAGAGG	1	1
ACAGTGCTGTATCAT	ACAGTGCTGTATCAT	1	1
AAATGGATCATTTAT	AAATGGATCATTTAT	1	1
AGATTCTGGGACAGC	AGATTCTGGGACAGC	1	1
CATCTTAATATATCA	CATCTTAATATATCA	2	1
ACTATACCTCTATGA	ACTATACCTCTATGA	1	1
TCCTCATAGGTGTCT	TCCTCATAGGTGTCT	1	1
GTTCCTTTACCACGT	GTTCCTTTACCACGT	1	1
GGACTCTTATGTTCA	GGACTCTTATGTTCA	1	1
TTATTATTCTATTTA	TTATTATTCTATTTA	1	1
AGACGAGGCGAGGCA	AGACGAGGCGAGGCA	1	1
GATGCCGTCCATGTG	GATGCCGTCCATGTG	2	1
CCATATCGCATTGAC	CCATATCGCATTGAC	1	1
GGATAATCATTTGAT	GGATAATCATTTGAT	1	1
CGTGTGTGGGTGCGG	CGTGTGTGGGTGCGG	1	1
ACAAGGACATTAAAA	ACAAGGACATTAAAA	1	1
AGTGGAGTCGATATT	AGTGGAGTCGATATT	1	1
GCTATCGTATTGGAA	GCTATCGTATTGGAA	1	1
TAAGATGCGGAAGGT	TAAGATGCGGAAGGT	1	1
CAGATTCCGCAATTA	CAGATTCCGCAATTA	1	1
GAAGTATCGATCGTC	GAAGTATCGATCGTC	2	1
GGTATGACAAGTCTG	GGTATGACAAGTCTG	1	1
CTACCGTTAAACCCG	CTACCGTTAAACCCG	1	1
AGTATCGTTCCAAGT	AGTATCGTTCCAAGT	1	1
GTACAAAATGCCAAT	GTACAAAATGCCAAT	1	1
AAGTTGTCATTGAAT	AAGTTGTCATTGAAT	1	1
GTAGTCTTCATGGAT	GTAGTCTTCATGGAT	1	1
GATAACTAGAATTTA	GATAACTAGAATTTA	1	1
GCGGGGAGAAGAACG	GCGGGGAGAAGAACG	1	1
CGAATGTAGTAGTTG	CGAATGTAGTAGTTG	1	1
TTCGTGGTGTTGCCT	TTCGTGGTGTTGCCT	1	1
TGTCGTGGTAGACTC	TGTCGTGGTAGACTC	1	1
GGGCGAGTGCCGGGT	GGGCGAGTGCCGGGT	1	1
TACACCTTGGGATGA	TACACCTTGGGATGA	1	1
AAATGAGAATAAAGA	AAATGAGAATAAAGA	1	1
AGAGGGCATCTAAAT	AGAGGGCATCTAAAT	1	1
AGATTTTGCTGTTCT	AGATTTTGCTGTTCT	1	1
TGACTGTGGTATTCT	TGACTGTGGTATTCT	1	1
TATGATTCTTCTTAG	TATGATTCTTCTTAG	1	1
TTTGGATTATCTAGG	TTTGGATTATCTAGG	2	1
CTTATGTTTCGTTTC	CTTATGTTTCGTTTC	1	1
ATCAATACGTCTGGC	ATCAATACGTCTGGC	1	1
TTCGGGCTCAGTTTT	TTCGGGCTCAGTTTT	1	1
GGCACCCAACATTAA	GGCACCCAACATTAA	1	1
TTAAGGGCAGTATTT	TTAAGGGCAGTATTT	2	1
GCATTACATAAATTA	GCATTACATAAATTA	2	1
AACGGATTTAACCAC	AACGGATTTAACCAC	1	1
GGCCTTTCCACTAGC	GGCCTTTCCACTAGC	1	1
GTAAACTTGTTATTC	GTAAACTTGTTATTC	1	1
CGTCGGGTAGCTATT	CGTCGGGTAGCTATT	1	1
TGAGGGGAAGCGTGG	TGAGGGGAAGCGTGG	2	1
AGGAGTCAGGGGCGT	AGGAGTCAGGGGCGT	1	1
ATGACAGCCTAAATT	ATGACAGCCTAAATT	1	1
CGATTGCTCATTGTA	CGATTGCTCATTGTA	1	1
TCTGCTATTTTTGGT	TCTGCTATTTTTGGT	1	1
TATGGCGAGGTCGTT	TATGGCGAGGTCGTT	1	1
CTTTTTTTAATGACA	CTTTTTTTAATGACA	1	1
ATCGAGGGAATTTAG	ATCGAGGGAATTTAG	1	1
GGTATCATGGTTCAG	GGTATCATGGTTCAG	1	1
ACTTCACAATGGATG	ACTTCACAATGGATG	1	1
AGCGTCTCGCTCCTA	AGCGTCTCGCTCCTA	1	1
GTACGTACTTAAGTC	GTACGTACTTAAGTC	2	1
ACGTAGTTGCACGAG	ACGTAGTTGCACGAG	1	1
AAAGATGAGTTCATA	AAAGATGAGTTCATA	2	1
CGTCGGAGTCATATT	CGTCGGAGTCATATT	1	1
AAATAGGTAGTGTCT	AAATAGGTAGTGTCT	2	1
TTAGCTGCTTCAGTC	TTAGCTGCTTCAGTC	1	1
CTACCACATTTTATT	CTACCACATTTTATT	1	1
CCCGGTGAGAATGTA	CCCGGTGAGAATGTA	1	1
AAATTGGGTGGAGAA	AAATTGGGTGGAGAA	2	1
TTCTACTTTAACATC	TTCTACTTTAACATC	1	1
TCCGGCTTGCAACGG	TCCGGCTTGCAACGG	1	1
ATAAGACGGGGTATG	ATAAGACGGGGTATG	1	1
TTTCTACTCTTTGTC	TTTCTACTCTTTGTC	1	1
TCAAACAGCTATAAT	TCAAACAGCTATAAT	1	1
GTACTCGGTGAATAC	GTACTCGGTGAATAC	1	1
CGGAGCAGTAGGTGT	CGGAGCAGTAGGTGT	1	1
TCTTTATGAATTATT	TCTTTATGAATTATT	1	1
ACCTCTACTGGTTTA	ACCTCTACTGGTTTA	1	1
GTTGATTACGATTTC	GTTGATTACGATTTC	1	1
CAGACAATCGGCGCG	CAGACAATCGGCGCG	2	1
TGAGGAGCATGAATA	TGAGGAGCATGAATA	2	1
TGTTAGGGGTACGGT	TGTTAGGGGTACGGT	1	1
GGCTGGCGAGGTGCG	GGCTGGCGAGGTGCG	1	1
CCTACATCTCTCTTA	CCTACATCTCTCTTA	1	1
TCAGAATGAAAATAA	TCAGAATGAAAATAA	1	1
CGGTTGATTAAGAAT	CGGTTGATTAAGAAT	1	1
TAAATCACCTAACTA	TAAATCACCTAACTA	1	1
AAAAACATTCCTCAC	AAAAACATTCCTCAC	1	1
CCTCCGGGGAGGCCG	CCTCCGGGGAGGCCG	1	1
ACACTTAGTTATGAA	ACACTTAGTTATGAA	2	1
GGTCACGTAGCGAGA	GGTCACGTAGCGAGA	1	1
GTGCATGTCATCATT	GTGCATGTCATCATT	1	1
TTAAATATAAAGCTA	TTAAATATAAAGCTA	1	1
ACTTCATAATGGCAT	ACTTCATAATGGCAT	1	1
TGCGATACATATCCC	TGCGATACATATCCC	1	1
CTAAGAATCTCATCA	CTAAGAATCTCATCA	1	1
GTAGACGAGGTGGCT	GTAGACGAGGTGGCT	1	1
CTCTGTTGAATGTTG	CTCTGTTGAATGTTG	1	1
GAATTTAATCTTTGT	GAATTTAATCTTTGT	1	1
GCGACATATTTTGAA	GCGACATATTTTGAA	2	1
GAAACTAAATCGGCT	GAAACTAAATCGGCT	1	1
TCGCAATCTGGCTTA	TCGCAATCTGGCTTA	1	1
TGGTCCTTATTTTCA	TGGTCCTTATTTTCA	1	1
AAACCGTGTTTTTTA	AAACCGTGTTTTTTA	1	1
CATATATGGGAATAT	CATATATGGGAATAT	1	1
CTGGTCTGACATGTT	CTGGTCTGACATGTT	1	1
ATAGGCTGATAGACA	ATAGGCTGATAGACA	2	1
TCATATCTTCTGTTT	TCATATCTTCTGTTT	1	1
AGTATGGGTGCTGTT	AGTATGGGTGCTGTT	1	1
GTACGAGTTCTATCA	GTACGAGTTCTATCA	2	1
GTTCGGTACACCTAC	GTTCGGTACACCTAC	1	1
GATGTAGCAGTCTTG	GATGTAGCAGTCTTG	2	1
CTACCGCACCTCTCT	CTACCGCACCTCTCT	1	1
GTATGGTTTCTTGAT	GTATGGTTTCTTGAT	1	1
GTGTTACTCTAGCGA	GTGTTACTCTAGCGA	1	1
TTGTGCAAGTCAAAT	TTGTGCAAGTCAAAT	1	1
AACAGAATTATTACT	AACAGAATTATTACT	1	1
GTTGACTGGGTCTGG	GTTGACTGGGTCTGG	1	1
CGGGGAGGTAAGCAT	CGGGGAGGTAAGCAT	1	1
GAGATATTTTGGGAG	GAGATATTTTGGGAG	1	1
ACAGGTAGAGTTTAT	ACAGGTAGAGTTTAT	2	1
TGCGTTGTTTGTTTT	TGCGTTGTTTGTTTT	1	1
AAGTTAATTAAGGTC	AAGTTAATTAAGGTC	1	1
GCTGGGCAAGGTTAA	GCTGGGCAAGGTTAA	1	1
AAACAGGTCAATTGC	AAACAGGTCAATTGC	2	1
TTGCATGTTTATGAA	TTGCATGTTTATGAA	1	1
GATGCCTCTGGGGCA	GATGCCTCTGGGGCA	3	1
ATTTATTTTTATAGA	ATTTATTTTTATAGA	1	1
ATCCTTAAATTACTT	ATCCTTAAATTACTT	1	1
TTCTTCAGTGCGTCG	TTCTTCAGTGCGTCG	1	1
ACTCATGCGCGAGTG	ACTCATGCGCGAGTG	1	1
GTTCTAGGCTTGCAT	GTTCTAGGCTTGCAT	1	1
ATAAACGGAGCTAAG	ATAAACGGAGCTAAG	1	1
CATGGCGTGCTAACT	CATGGCGTGCTAACT	1	1
TTCATATGAGTCCAT	TTCATATGAGTCCAT	1	1
CAGCATGCGATTAAA	CAGCATGCGATTAAA	1	1
CTACCAGAATGATTG	CTACCAGAATGATTG	1	1
TTTGTCTGAATAATC	TTTGTCTGAATAATC	1	1
CGTCTATAAGCTGTT	CGTCTATAAGCTGTT	1	1
GCTCAGTAGCCTGTA	GCTCAGTAGCCTGTA	1	1
ATATGACAAACCGGT	ATATGACAAACCGGT	2	1
ACGTCAGCATAAAAC	ACGTCAGCATAAAAC	1	1
TGATCGAGTTCTTTC	TGATCGAGTTCTTTC	1	1
ACACCAAAATCGTGT	ACACCAAAATCGTGT	1	1
GACTATACGTTACAA	GACTATACGTTACAA	1	1
GAGCTCATTTAAGGT	GAGCTCATTTAAGGT	2	1
GACTTACATCTATAT	GACTTACATCTATAT	1	1
ATAAGGAACTAATGT	ATAAGGAACTAATGT	1	1
GCGTCCAGGGAGGCT	GCGTCCAGGGAGGCT	1	1
TTGTCGATTTTGAAG	TTGTCGATTTTGAAG	1	1
TTGGACGGGGCGCAA	TTGGACGGGGCGCAA	1	1
GATGTGGCGTTTGGC	GATGTGGCGTTTGGC	1	1
CAACCTCGGCTCTTC	CAACCTCGGCTCTTC	1	1
ACAAACTATGATATC	ACAAACTATGATATC	1	1
TACATAAGGTTGTAA	TACATAAGGTTGTAA	1	1
GTTTCTAGTTTCACA	GTTTCTAGTTTCACA	1	1
ATCAAGCTGGCATTA	ATCAAGCTGGCATTA	1	1
AAAAAGGCCAGGGGG	AAAAAGGCCAGGGGG	1	1
AGAGGTCATTGAGAT	AGAGGTCATTGAGAT	1	1
ACCCTGTTTTGTCTG	ACCCTGTTTTGTCTG	3	1
TTTCTGAACAGTTGT	TTTCTGAACAGTTGT	1	1
GTCCGGCGCCCTTGT	GTCCGGCGCCCTTGT	1	1
CTTACCTGCTTCAAG	CTTACCTGCTTCAAG	1	1
GTAGGCCGGGGGGTG	GTAGGCCGGGGGGTG	1	1
TGCGCGATGCTTATC	TGCGCGATGCTTATC	1	1
CTTTGGTATATTTTT	CTTTGGTATATTTTT	2	1
AATTGAGTTGTCTTG	AATTGAGTTGTCTTG	1	1
TAAAGCCATATATAC	TAAAGCCATATATAC	1	1
GGGACTGTTGTTGAG	GGGACTGTTGTTGAG	1	1
CAAAATGTTTTGCAA	CAAAATGTTTTGCAA	1	1
TGACTCCAATCTATA	TGACTCCAATCTATA	2	1
GTTCGCAACCCGCCC	GTTCGCAACCCGCCC	1	1
CAGCAATTGGTAGGT	CAGCAATTGGTAGGT	1	1
ACTGGTGCCAGCTAT	ACTGGTGCCAGCTAT	1	1
TTGTACGCGCTTAAT	TTGTACGCGCTTAAT	1	1
TTCCCTACACTCCTA	TTCCCTACACTCCTA	1	1
GAATAAAAGTTCGAG	GAATAAAAGTTCGAG	1	1
ACTCCTTCAATAACT	ACTCCTTCAATAACT	1	1
ATATTACACCTAGAA	ATATTACACCTAGAA	1	1
GTGGGCGGGGGGTAG	GTGGGCGGGGGGTAG	1	1
TTATTAGGTCCCCTT	TTATTAGGTCCCCTT	2	1
TGCCCCGGCGACGGG	TGCCCCGGCGACGGG	1	1
ATAACAGCCGTGGCT	ATAACAGCCGTGGCT	1	1
TTCAACTACGACTTC	TTCAACTACGACTTC	2	1
CCAGTCTCTCTGGTC	CCAGTCTCTCTGGTC	2	1
TGTTTTGAGTTAAAC	TGTTTTGAGTTAAAC	2	1
GGCGTGGCTGGGGGG	GGCGTGGCTGGGGGG	1	1
GAACCGGATTCGATT	GAACCGGATTCGATT	1	1
AGCAAGCGGGAATCT	AGCAAGCGGGAATCT	1	1
CTGACTAAGTTTCAG	CTGACTAAGTTTCAG	2	1
CTTATTCTTACTTTA	CTTATTCTTACTTTA	1	1
GATCTTCACATTTTC	GATCTTCACATTTTC	1	1
TATTACGGTGTGGAC	TATTACGGTGTGGAC	1	1
AAATAACGCGTGCGA	AAATAACGCGTGCGA	1	1
CTTCAAACCGCATTT	CTTCAAACCGCATTT	1	1
TTATACAAACCCTGG	TTATACAAACCCTGG	1	1
GCTCTCACATTCCAC	GCTCTCACATTCCAC	1	1
TTGAGTTCTCGTTAA	TTGAGTTCTCGTTAA	1	1
GGCGCGGGCAGGCTG	GGCGCGGGCAGGCTG	1	1
TTAAGGGTCGCCCGC	TTAAGGGTCGCCCGC	1	1
GTATAACATGGGACT	GTATAACATGGGACT	1	1
TACAAACTGGTAGAT	TACAAACTGGTAGAT	1	1
GGTTGTGGATTCTCA	GGTTGTGGATTCTCA	1	1
GCTCTCGGAGTGTGA	GCTCTCGGAGTGTGA	1	1
TTGACATAATGACGT	TTGACATAATGACGT	1	1
GCACCCGGGGTGGCT	GCACCCGGGGTGGCT	2	1
GTACTTAGGTTTATA	GTACTTAGGTTTATA	1	1
AGGGATTCAATCTCT	AGGGATTCAATCTCT	1	1
CCATAATTATTAGGA	CCATAATTATTAGGA	2	1
CGTCGCCATGCGTTC	CGTCGCCATGCGTTC	1	1
ATTCCCACTGCTTGA	ATTCCCACTGCTTGA	1	1
CATTAGTATTGCACA	CATTAGTATTGCACA	2	1
GAGCATAGTTTGGTG	GAGCATAGTTTGGTG	1	1
TGGAAGAAGCTTGTT	TGGAAGAAGCTTGTT	1	1
TATATACGCGATATC	TATATACGCGATATC	1	1
GCGGGATGTCCGTTA	GCGGGATGTCCGTTA	1	1
TCTGATATCACTCGT	TCTGATATCACTCGT	1	1
GAATTTTCCTATGAA	GAATTTTCCTATGAA	1	1
TCATTTCTCTTATCA	TCATTTCTCTTATCA	1	1
TAATGTTTGGCTAGA	TAATGTTTGGCTAGA	1	1
AAAAGCGTGATTTGT	AAAAGCGTGATTTGT	1	1
ATCACTTACATACAT	ATCACTTACATACAT	1	1
ACCATCTTTTTAAAG	ACCATCTTTTTAAAG	1	1
TGTATGTGTTCATTC	TGTATGTGTTCATTC	1	1
GTACGGGCAGGTAGT	GTACGGGCAGGTAGT	1	1
TTGACTTATTTTTGT	TTGACTTATTTTTGT	1	1
CGTTGTGTGGATCGG	CGTTGTGTGGATCGG	1	1
GCCAATGTCACGGCG	GCCAATGTCACGGCG	1	1
TATAGGTACATCATC	TATAGGTACATCATC	1	1
ACTAGGTTTATGTAT	ACTAGGTTTATGTAT	1	1
AAGAAAAGCAATCTT	AAGAAAAGCAATCTT	1	1
GTGCACCAAATGTTG	GTGCACCAAATGTTG	1	1
TCCTTTCTAAGCTTC	TCCTTTCTAAGCTTC	1	1
GTCAATGCAGTTTCA	GTCAATGCAGTTTCA	1	1
TAATTCGAACAGATC	TAATTCGAACAGATC	1	1
GTTCAGTGCGCTAAA	GTTCAGTGCGCTAAA	1	1
TTGATATTTTTAGAT	TTGATATTTTTAGAT	1	1
TTATGGCGTTATTCG	TTATGGCGTTATTCG	1	1
TACAGGCTTTCGGTA	TACAGGCTTTCGGTA	1	1
TTTATGATAACTTTT	TTTATGATAACTTTT	4	1
TATGTGTCTTTCTTC	TATGTGTCTTTCTTC	1	1
TTTTTCTTCAGTCGG	TTTTTCTTCAGTCGG	1	1
GTTCTTACCTAGTGT	GTTCTTACCTAGTGT	1	1
AATGACTTCTGATTT	AATGACTTCTGATTT	1	1
GGGTGCTACAGATCT	GGGTGCTACAGATCT	1	1
GAGTCACCGCTGGTA	GAGTCACCGCTGGTA	1	1
ACACTGTCCATTTAC	ACACTGTCCATTTAC	1	1
TAGTAGGGCGAAGAT	TAGTAGGGCGAAGAT	1	1
TCATGAGGAACGCTA	TCATGAGGAACGCTA	1	1
CGCGCTAAGAGCTAT	CGCGCTAAGAGCTAT	1	1
TTGTACGTGATTTCT	TTGTACGTGATTTCT	3	1
TCCTCTGTCTTCAAT	TCCTCTGTCTTCAAT	1	1
AAGCTAAGCTAAACG	AAGCTAAGCTAAACG	1	1
GGCAACGATTGTTCT	GGCAACGATTGTTCT	1	1
GTCGAAGTCGTCGGG	GTCGAAGTCGTCGGG	1	1
GCACTTAAATACTTG	GCACTTAAATACTTG	1	1
CGTAAGTATCTGTAA	CGTAAGTATCTGTAA	1	1
TATGAAAAATCACTC	TATGAAAAATCACTC	1	1
GTGATTGCGGATTAG	GTGATTGCGGATTAG	1	1
CAGCCACATTCCTAT	CAGCCACATTCCTAT	1	1
TAGCTTACTATGAAA	TAGCTTACTATGAAA	2	1
CGTTCATTAAATAAA	CGTTCATTAAATAAA	1	1
CAGGTTACAAGTAAT	CAGGTTACAAGTAAT	1	1
CTAACGCTTTTTGGG	CTAACGCTTTTTGGG	1	1
TGAACACCGAGATTA	TGAACACCGAGATTA	1	1
CTATTCACCTCGTTC	CTATTCACCTCGTTC	1	1
TTTCCCTAGGTATGT	TTTCCCTAGGTATGT	1	1
GCGGCCAGGCGGGAG	GCGGCCAGGCGGGAG	1	1
TTCCACGTATCCGTT	TTCCACGTATCCGTT	1	1
AGTGGTGCGTTGGGT	AGTGGTGCGTTGGGT	4	1
GGCTCTAGGCACATG	GGCTCTAGGCACATG	1	1
TATAGTATTCTGTAG	TATAGTATTCTGTAG	1	1
GATTTTCAATTGTTC	GATTTTCAATTGTTC	3	1
GGCCAGTAAGGGTGC	GGCCAGTAAGGGTGC	1	1
ATTGTGGCTTTTGAC	ATTGTGGCTTTTGAC	1	1
ACTCGAACGTCTGTC	ACTCGAACGTCTGTC	1	1
AACACCTTAGTTTAA	AACACCTTAGTTTAA	1	1
GTTAGTTAAACCCAT	GTTAGTTAAACCCAT	1	1
AAGAGGTTAGGACAT	AAGAGGTTAGGACAT	3	1
CGGTATAGTCTATTT	CGGTATAGTCTATTT	1	1
GTAAGCGCGGCAGCG	GTAAGCGCGGCAGCG	1	1
CAAGTGATCTTACCT	CAAGTGATCTTACCT	1	1
GAGTGCGTGGAGGTT	GAGTGCGTGGAGGTT	1	1
CTGTCGAGTATAGTT	CTGTCGAGTATAGTT	2	1
ATCATTAAATATAAA	ATCATTAAATATAAA	1	1
GTAGGCAGTTACCTA	GTAGGCAGTTACCTA	1	1
ATAAACCTTCAGTAT	ATAAACCTTCAGTAT	1	1
CCCTTGATAGTAACT	CCCTTGATAGTAACT	1	1
CTTGAACTGTTCGTT	CTTGAACTGTTCGTT	1	1
ACTTATATTACAGTA	ACTTATATTACAGTA	1	1
ACGCTATTAGAGCTT	ACGCTATTAGAGCTT	1	1
GCTTGATCCACTACT	GCTTGATCCACTACT	1	1
ATTTGATAGTTTAAG	ATTTGATAGTTTAAG	1	1
CTCTAGTATGCTGGT	CTCTAGTATGCTGGT	1	1
TATTATCATCTGAGC	TATTATCATCTGAGC	1	1
GGGTCATAAATGTAC	GGGTCATAAATGTAC	3	1
TTGCACTTTTGCGAT	TTGCACTTTTGCGAT	1	1
TTTCCCGGTTCTCTT	TTTCCCGGTTCTCTT	1	1
ATTATTGGCAAGCGG	ATTATTGGCAAGCGG	1	1
TAGCATACTGAGGAA	TAGCATACTGAGGAA	1	1
GAAGACATGATTTGG	GAAGACATGATTTGG	1	1
AACATCACGCTATAC	AACATCACGCTATAC	2	1
GGCATATTTTGTTGA	GGCATATTTTGTTGA	1	1
AACACTCGTCTTTAC	AACACTCGTCTTTAC	1	1
GCGTTGTGGTCACTT	GCGTTGTGGTCACTT	1	1
GTTTAGAGGAACTGG	GTTTAGAGGAACTGG	1	1
TTCGGTATCAAGTAA	TTCGGTATCAAGTAA	1	1
TACTATACACACAAG	TACTATACACACAAG	1	1
GCGAATAAAGCTCTA	GCGAATAAAGCTCTA	1	1
AGCATTATCTTTACC	AGCATTATCTTTACC	1	1
CGTTTAACCGCTATT	CGTTTAACCGCTATT	1	1
CACGCATTATTGTGT	CACGCATTATTGTGT	1	1
AACTTGTTGCTAATC	AACTTGTTGCTAATC	1	1
AGTTGGAAGGTAAAC	AGTTGGAAGGTAAAC	1	1
CAATACTTAATTTTT	CAATACTTAATTTTT	1	1
TCAAGTCTTATTTTA	TCAAGTCTTATTTTA	1	1
AAAGTGATGATTCTT	AAAGTGATGATTCTT	1	1
GTCTACGCTTAGTGG	GTCTACGCTTAGTGG	1	1
GATAGCTGTTATTTA	GATAGCTGTTATTTA	1	1
TTTCAGAGGACTTTT	TTTCAGAGGACTTTT	1	1
GGACTATTTAATAGT	GGACTATTTAATAGT	1	1
AGGAGTGGTGCATAT	AGGAGTGGTGCATAT	1	1
GCTAATGTCCAGTTG	GCTAATGTCCAGTTG	1	1
TCGTGTGTACGGCTG	TCGTGTGTACGGCTG	1	1
GTAGTGATTGCTATG	GTAGTGATTGCTATG	2	1
CGGGAATTGCCGTCA	CGGGAATTGCCGTCA	2	1
GGGGGGTAGCGTGTG	GGGGGGTAGCGTGTG	1	1
GTTTGTCCAACCCTA	GTTTGTCCAACCCTA	1	1
ATAGGACTCCTCGGG	ATAGGACTCCTCGGG	1	1
AAACATCTCCTATCT	AAACATCTCCTATCT	1	1
ATTACACTGCTTATA	ATTACACTGCTTATA	1	1
AGAAGTTGTCAGGTC	AGAAGTTGTCAGGTC	1	1
GTTGGAAGTATGTAT	GTTGGAAGTATGTAT	1	1
AGATATGACAGTTGA	AGATATGACAGTTGA	1	1
GGTGGCGCTATTGCG	GGTGGCGCTATTGCG	1	1
ATCTGGTTAATCTTC	ATCTGGTTAATCTTC	1	1
CACACGCTTGAGATC	CACACGCTTGAGATC	1	1
GCGGTTTGGTGGGGA	GCGGTTTGGTGGGGA	1	1
TCCGATGGCCTTTGT	TCCGATGGCCTTTGT	1	1
AAAAGATGTGCCATC	AAAAGATGTGCCATC	1	1
GATCTTTGACATTTG	GATCTTTGACATTTG	1	1
TCTTACGTTTATGAA	TCTTACGTTTATGAA	1	1
GAATCTAGCCATTTA	GAATCTAGCCATTTA	1	1
TATTGCTATATGGTA	TATTGCTATATGGTA	1	1
ATCGATTTCAATTTA	ATCGATTTCAATTTA	1	1
TCTGGTCATTGAGGT	TCTGGTCATTGAGGT	1	1
AGCTGTGGTGGGGTG	AGCTGTGGTGGGGTG	1	1
TTCCTGAAGTCGTTT	TTCCTGAAGTCGTTT	1	1
GGGGGCCTGGGGGGG	GGGGGCCTGGGGGGG	1	1
AATAAGCGTCCACTT	AATAAGCGTCCACTT	1	1
CATCGATTTCGATAT	CATCGATTTCGATAT	2	1
CTTACACCAAACAAC	CTTACACCAAACAAC	2	1
ATTCTTTGAACTATA	ATTCTTTGAACTATA	1	1
CTTGCGGAACCATAT	CTTGCGGAACCATAT	1	1
TGAGCGAATTGTTCA	TGAGCGAATTGTTCA	1	1
TGACGGTCTAGAAGT	TGACGGTCTAGAAGT	1	1
GGTCGTACGTAGCGG	GGTCGTACGTAGCGG	1	1
GTTCTTATGTCGACT	GTTCTTATGTCGACT	1	1
TATTTACTTAGTCGA	TATTTACTTAGTCGA	1	1
TTCAAAGATAAGCTA	TTCAAAGATAAGCTA	1	1
GTAGTTTTGAGTCGT	GTAGTTTTGAGTCGT	1	1
CTACATTACTTGGTA	CTACATTACTTGGTA	2	1
AAACATTCTCTTTTT	AAACATTCTCTTTTT	2	1
GGGGTGGGTTGCAGT	GGGGTGGGTTGCAGT	2	1
ATTGCATGTAATTTT	ATTGCATGTAATTTT	1	1
CCGGTTAATTGGGTA	CCGGTTAATTGGGTA	1	1
GGCATCGATATGATG	GGCATCGATATGATG	1	1
TGGCGTTCCTCCGTG	TGGCGTTCCTCCGTG	1	1
TGTCTCATTGAGAAT	TGTCTCATTGAGAAT	1	1
CGGGTTAACCTCTTA	CGGGTTAACCTCTTA	1	1
TTCCTTACGCCTCGA	TTCCTTACGCCTCGA	1	1
GCTCATTTTGGGGAA	GCTCATTTTGGGGAA	1	1
CTGGATCTTGGCATA	CTGGATCTTGGCATA	1	1
TCACTCATCTACCGG	TCACTCATCTACCGG	1	1
ACTGTGATGGTTCTG	ACTGTGATGGTTCTG	1	1
AATTGGCACCTTGGG	AATTGGCACCTTGGG	1	1
ATCTTAACAAAACTT	ATCTTAACAAAACTT	1	1
ATATATTAGTATGTC	ATATATTAGTATGTC	1	1
ATTTCGGTACTTATT	ATTTCGGTACTTATT	1	1
AGGCTACTAGGAAAT	AGGCTACTAGGAAAT	1	1
CTGCTTGCTTATTCA	CTGCTTGCTTATTCA	1	1
TTTCAAGGTATGAGT	TTTCAAGGTATGAGT	1	1
ACCTCAAGGTATATT	ACCTCAAGGTATATT	1	1
ATGCATAGTGCATGT	ATGCATAGTGCATGT	1	1
GCTGACTGCACCGAA	GCTGACTGCACCGAA	2	1
ATCTAAGATCACACA	ATCTAAGATCACACA	1	1
ATTTAATCTTTCTCT	ATTTAATCTTTCTCT	1	1
CGGGGAGCGGGTTCC	CGGGGAGCGGGTTCC	1	1
GAACCATCTCGTAGT	GAACCATCTCGTAGT	1	1
ATTAAGCTTCGAGAT	ATTAAGCTTCGAGAT	1	1
TAAGGATTTTCTCGA	TAAGGATTTTCTCGA	1	1
GCTGAGTCTTTACTT	GCTGAGTCTTTACTT	1	1
TGGGGGTGCGGAGGC	TGGGGGTGCGGAGGC	1	1
CACATCTAACCGTGT	CACATCTAACCGTGT	3	1
TGAAATTAATAATGA	TGAAATTAATAATGA	1	1
GACCTTAATATTTTA	GACCTTAATATTTTA	1	1
AAGTCAGCATTGGGG	AAGTCAGCATTGGGG	1	1
TCTATCTTAATGTCT	TCTATCTTAATGTCT	1	1
TATCGTTTTATCCTA	TATCGTTTTATCCTA	1	1
CTGTGCATGCTTTTC	CTGTGCATGCTTTTC	1	1
GATTTAGTTGAGAAG	GATTTAGTTGAGAAG	1	1
TCATTTTTTCTGTGT	TCATTTTTTCTGTGT	1	1
GTTCAGGTCAAGGTG	GTTCAGGTCAAGGTG	1	1
TACAATGTAGGGGTA	TACAATGTAGGGGTA	1	1
CAAGTTACTTTTAAA	CAAGTTACTTTTAAA	1	1
ATTCAGCACATTTTT	ATTCAGCACATTTTT	1	1
TATCGAATCCGTGTT	TATCGAATCCGTGTT	1	1
GAGTCATGCACGTGA	GAGTCATGCACGTGA	1	1
TTTTTTCAGTGGATG	TTTTTTCAGTGGATG	1	1
TACATTTGTATTTGT	TACATTTGTATTTGT	1	1
CTTAGCCGCCCACGA	CTTAGCCGCCCACGA	1	1
ACCAGTACTGGGATG	ACCAGTACTGGGATG	1	1
CAAGACTTTAGGTGT	CAAGACTTTAGGTGT	1	1
ATTTAAGAGGGTACT	ATTTAAGAGGGTACT	2	1
ATTGTGGGCATATGA	ATTGTGGGCATATGA	1	1
ACTTGGGCAACGTTA	ACTTGGGCAACGTTA	1	1
TTACTTTTAATTGCA	TTACTTTTAATTGCA	1	1
TTTGTATATTTTGTC	TTTGTATATTTTGTC	3	1
ATTCGATTTTTGTCA	ATTCGATTTTTGTCA	1	1
CCGTGCTCGTTACTG	CCGTGCTCGTTACTG	2	1
CTTCTAAAAAATACT	CTTCTAAAAAATACT	1	1
TCTGGTCCGGCGATT	TCTGGTCCGGCGATT	1	1
AACTTCGTTGCTAAG	AACTTCGTTGCTAAG	1	1
ATTTCATGTTTAGTC	ATTTCATGTTTAGTC	1	1
ACAGTTTTCAGCGTG	ACAGTTTTCAGCGTG	2	1
GAGATGTCGTCTATA	GAGATGTCGTCTATA	1	1
TATAGGGGGTTGTAA	TATAGGGGGTTGTAA	1	1
GAATCCGTTTTATCA	GAATCCGTTTTATCA	1	1
AATCCTTTGTACTTT	AATCCTTTGTACTTT	1	1
GTCACCCCAGCCTGA	GTCACCCCAGCCTGA	1	1
AGTATTATGGCGTGG	AGTATTATGGCGTGG	1	1
TTAATGCACATAGTA	TTAATGCACATAGTA	1	1
CCTATTAATAAACTG	CCTATTAATAAACTG	1	1
CCTTTCGATTATTGT	CCTTTCGATTATTGT	1	1
AACTTAAGGGCGCAT	AACTTAAGGGCGCAT	1	1
CCTACATCGCAATGT	CCTACATCGCAATGT	1	1
ATTTGCTTGCAGAAA	ATTTGCTTGCAGAAA	1	1
GTCCCTAGTGAGTCT	GTCCCTAGTGAGTCT	1	1
TAGCAGCTATAAATC	TAGCAGCTATAAATC	1	1
ACTTCGTTATATCCT	ACTTCGTTATATCCT	1	1
GGGGGTCCGTTTAGC	GGGGGTCCGTTTAGC	1	1
GTCTGCCTATTATAG	GTCTGCCTATTATAG	1	1
GGGCGCCAAATTTGG	GGGCGCCAAATTTGG	1	1
CAACAATCAGCTTCT	CAACAATCAGCTTCT	1	1
TCCGGGTTAGTAGGT	TCCGGGTTAGTAGGT	1	1
TTAACTACTCCCATT	TTAACTACTCCCATT	1	1
CTCCTATATCATCAT	CTCCTATATCATCAT	1	1
GTTTAGTGTCTCGGT	GTTTAGTGTCTCGGT	1	1
GGACATCGTCAAAGA	GGACATCGTCAAAGA	1	1
GTTGCTAGAGTCGTC	GTTGCTAGAGTCGTC	2	1
CCAAACGCCGGCTTC	CCAAACGCCGGCTTC	3	1
AAGCTCATGGATGAA	AAGCTCATGGATGAA	1	1
TTTCAGCGAAAAAAT	TTTCAGCGAAAAAAT	1	1
GATGTCTTGATTAAT	GATGTCTTGATTAAT	1	1
ACCGTGAGTCATAAT	ACCGTGAGTCATAAT	1	1
TCAATAAGAAACTTA	TCAATAAGAAACTTA	1	1
CTTCAATAAGTTATT	CTTCAATAAGTTATT	1	1
TACTCTACGCTTCTT	TACTCTACGCTTCTT	1	1
CCGCTACACCGTTAA	CCGCTACACCGTTAA	1	1
TCCGCCTGCTGGTGA	TCCGCCTGCTGGTGA	1	1
GTCCTCTGTAATCAT	GTCCTCTGTAATCAT	3	1
TGTACTCTTAGACCA	TGTACTCTTAGACCA	1	1
TTATCTACGTAGTAG	TTATCTACGTAGTAG	1	1
ATGTGTCGGATCCAG	ATGTGTCGGATCCAG	1	1
TGTTAGACCGCAGGG	TGTTAGACCGCAGGG	1	1
ATAATGTTCCAACAT	ATAATGTTCCAACAT	1	1
CTAACCGTAGCGTCC	CTAACCGTAGCGTCC	1	1
TTTAAAACTGACTTA	TTTAAAACTGACTTA	1	1
ACGTAACTAATATGT	ACGTAACTAATATGT	1	1
GATCATTGTGGTAAA	GATCATTGTGGTAAA	1	1
GAGATCTTACGGATA	GAGATCTTACGGATA	1	1
GTCGCTGCGTGGTGG	GTCGCTGCGTGGTGG	1	1
ACGTTCACTTACTGT	ACGTTCACTTACTGT	1	1
GCCGGGGGGGTTATT	GCCGGGGGGGTTATT	1	1
CGCTTCAGGCTAGGC	CGCTTCAGGCTAGGC	1	1
GGAAGCTCGGTACAA	GGAAGCTCGGTACAA	1	1
ATTAATAAGTGCTTA	ATTAATAAGTGCTTA	1	1
TTAGGTTAGCTGTTT	TTAGGTTAGCTGTTT	1	1
GTCCGTTATGACTTG	GTCCGTTATGACTTG	1	1
TGCATTTCTCTGTGT	TGCATTTCTCTGTGT	1	1
CTTGGGGAATAAATC	CTTGGGGAATAAATC	1	1
GGAGAAGGATTTGCA	GGAGAAGGATTTGCA	1	1
TAAATTCATGTCCTC	TAAATTCATGTCCTC	1	1
GGATTTCCTTTCTAG	GGATTTCCTTTCTAG	1	1
GCTTAACCTTGTCTA	GCTTAACCTTGTCTA	1	1
CTCTATAAGTTCTCC	CTCTATAAGTTCTCC	1	1
CGTTTCCCAGTGTCT	CGTTTCCCAGTGTCT	1	1
AAAAGTGGTTTTGGT	AAAAGTGGTTTTGGT	1	1
ATGAGGATTTTATAT	ATGAGGATTTTATAT	1	1
GAATTAAATGTAAAC	GAATTAAATGTAAAC	1	1
GTGTCAACGTTACGT	GTGTCAACGTTACGT	1	1
GTATCATCTGTCGCG	GTATCATCTGTCGCG	1	1
GCCGGTTCGTTCACA	GCCGGTTCGTTCACA	1	1
TATTTATTTGAACTT	TATTTATTTGAACTT	1	1
CTGCCTTCCTCTAGG	CTGCCTTCCTCTAGG	1	1
GTTTCGGTGTGGTAT	GTTTCGGTGTGGTAT	1	1
TCCGGCCCGGATTAC	TCCGGCCCGGATTAC	1	1
GTAATTCGGAAAGAA	GTAATTCGGAAAGAA	1	1
GATCCATGGACTGTG	GATCCATGGACTGTG	1	1
CTACTATGTTAATAA	CTACTATGTTAATAA	1	1
GAGGGTTCGGTCGGA	GAGGGTTCGGTCGGA	1	1
AACGCAGTAAACCCA	AACGCAGTAAACCCA	1	1
TTGTTCAGCCTCCGA	TTGTTCAGCCTCCGA	1	1
CGCGCTAGGTTGCTG	CGCGCTAGGTTGCTG	1	1
TTTCAACTGTATCTT	TTTCAACTGTATCTT	1	1
GTCCTTTGTTTAAAA	GTCCTTTGTTTAAAA	1	1
AGTCATTTTTACGGT	AGTCATTTTTACGGT	1	1
TAAGGCCGTTAGTCA	TAAGGCCGTTAGTCA	1	1
TGGTGGGGGGAGCGG	TGGTGGGGGGAGCGG	1	1
CCGCCGGATGATATG	CCGCCGGATGATATG	1	1
TCTAAGTTGTCCCGG	TCTAAGTTGTCCCGG	1	1
CAACGTGTTCTTTCT	CAACGTGTTCTTTCT	1	1
GTTTAGGTTTGCTCT	GTTTAGGTTTGCTCT	1	1
TTCAATCTTCGAATG	TTCAATCTTCGAATG	1	1
TTATCGAACTTAGTA	TTATCGAACTTAGTA	1	1
TGTTAAGTCGATATA	TGTTAAGTCGATATA	1	1
CTTGCTATAATATTT	CTTGCTATAATATTT	1	1
TTCCAGCGGTTAAAG	TTCCAGCGGTTAAAG	1	1
TTGATCTGCAATTAT	TTGATCTGCAATTAT	1	1
ATCGTGCACTAGACG	ATCGTGCACTAGACG	1	1
CAGAAACCAAATCCT	CAGAAACCAAATCCT	1	1
TACGCTGTGAGTCGT	TACGCTGTGAGTCGT	1	1
TGTGTTTTCTGTAGT	TGTGTTTTCTGTAGT	1	1
ATCGGGTTTCCTAAA	ATCGGGTTTCCTAAA	1	1
TGTTTTCCGAATGGA	TGTTTTCCGAATGGA	1	1
TTTGAAGTTGGTTGA	TTTGAAGTTGGTTGA	1	1
TATATCATTCCGTGT	TATATCATTCCGTGT	2	1
GTAGCCATACGTTAT	GTAGCCATACGTTAT	1	1
AGAATTGTATATAGT	AGAATTGTATATAGT	1	1
GGGCTTTGATAATCT	GGGCTTTGATAATCT	1	1
TATAAAGCAAAGAAA	TATAAAGCAAAGAAA	1	1
TCACGTTACATAATA	TCACGTTACATAATA	1	1
GTGATAAATGTATTA	GTGATAAATGTATTA	1	1
ATAGTGGAGATAGGT	ATAGTGGAGATAGGT	1	1
TAGAATTTATTAAGT	TAGAATTTATTAAGT	1	1
TAGTGCAGTAACATT	TAGTGCAGTAACATT	1	1
TAAAACGCATATTTA	TAAAACGCATATTTA	1	1
AAAGAGCGTCGCAGT	AAAGAGCGTCGCAGT	1	1
TTGTTCAGGGTTTTA	TTGTTCAGGGTTTTA	1	1
CCGGATTCATTAGTT	CCGGATTCATTAGTT	1	1
CTACTTGGTGTTTTC	CTACTTGGTGTTTTC	1	1
TTGCAGCACGCGGAA	TTGCAGCACGCGGAA	1	1
GAGGGGGGTGGGGGG	GAGGGGGGTGGGGGG	1	1
GTCGCTATTCTCCAT	GTCGCTATTCTCCAT	1	1
TTACATGTGTCATTG	TTACATGTGTCATTG	1	1
GTACGGCCAAAGGTT	GTACGGCCAAAGGTT	2	1
TGTGAAGCCGATCGA	TGTGAAGCCGATCGA	1	1
TAATGGGGCTCCTAG	TAATGGGGCTCCTAG	1	1
CAAGGTAAGTACTCT	CAAGGTAAGTACTCT	1	1
TACCTACTCATACGT	TACCTACTCATACGT	1	1
GTCCTGTATCATCGT	GTCCTGTATCATCGT	1	1
AAAATCGCATATCTT	AAAATCGCATATCTT	1	1
ACATCTTGTATGCTA	ACATCTTGTATGCTA	1	1
TGGGGAACCGCAAGT	TGGGGAACCGCAAGT	1	1
GGATTAAAGGCAACC	GGATTAAAGGCAACC	1	1
TGTAACGTACCATGT	TGTAACGTACCATGT	1	1
AAAGCTTTGTGGTGT	AAAGCTTTGTGGTGT	1	1
TTGTGAACCGATTTG	TTGTGAACCGATTTG	1	1
ATGTTACTGATCTTT	ATGTTACTGATCTTT	2	1
GCAAAGTGTTGCTGC	GCAAAGTGTTGCTGC	1	1
GTAACGAAAGAGATC	GTAACGAAAGAGATC	1	1
TTATCAGGGCGGGAA	TTATCAGGGCGGGAA	2	1
TGAACGACTCGAATC	TGAACGACTCGAATC	1	1
ACTTGCTAATCACAG	ACTTGCTAATCACAG	1	1
TGTCTCTATAGAGCA	TGTCTCTATAGAGCA	1	1
GCCCATATGTTCACT	GCCCATATGTTCACT	1	1
AAGCTCCTTGCGTGG	AAGCTCCTTGCGTGG	1	1
ATCCAATACTGGCAT	ATCCAATACTGGCAT	1	1
ACTGTAGGATCTAAT	ACTGTAGGATCTAAT	1	1
ATAGCGAGCGCAGTG	ATAGCGAGCGCAGTG	1	1
ATAAGTCATAAATCA	ATAAGTCATAAATCA	1	1
CTGGTGAATGTATTC	CTGGTGAATGTATTC	2	1
CGAGTCTGAATGAAT	CGAGTCTGAATGAAT	1	1
GGCCGAGGTGGGATC	GGCCGAGGTGGGATC	1	1
TAGATCGTGGCGAAT	TAGATCGTGGCGAAT	1	1
AGGGGCGCGGGCGTG	AGGGGCGCGGGCGTG	1	1
GAAATGGAGGTTGTG	GAAATGGAGGTTGTG	1	1
GAAATAATGGTGCGT	GAAATAATGGTGCGT	1	1
GGCGTGGATGGGTGG	GGCGTGGATGGGTGG	1	1
TCGTTGACGACTCAA	TCGTTGACGACTCAA	1	1
GGTTTAATCTTTAAT	GGTTTAATCTTTAAT	1	1
CCTCACGCCGATATT	CCTCACGCCGATATT	1	1
GTTTTCCTTTCTTCA	GTTTTCCTTTCTTCA	1	1
GCAGCATCCATTTCA	GCAGCATCCATTTCA	1	1
GAGACTCTAAGGTTG	GAGACTCTAAGGTTG	1	1
GACTCAAACGCGTTA	GACTCAAACGCGTTA	1	1
GTGGTTCGGAACTGA	GTGGTTCGGAACTGA	1	1
TATTGTCTTATTGTC	TATTGTCTTATTGTC	1	1
CCAGCATAAGTTCTA	CCAGCATAAGTTCTA	1	1
TCTGGTCCATGCTTA	TCTGGTCCATGCTTA	1	1
TATCTAAGTGCAGAG	TATCTAAGTGCAGAG	1	1
GAAGTTTCATTTACC	GAAGTTTCATTTACC	1	1
GTTCGTATCGATAGC	GTTCGTATCGATAGC	2	1
TAGCTTTTCCCGCAG	TAGCTTTTCCCGCAG	1	1
TACGATGTACGTATA	TACGATGTACGTATA	1	1
CCCGGGGGGGCACCT	CCCGGGGGGGCACCT	1	1
GTGATTGTCTTACCG	GTGATTGTCTTACCG	1	1
AAAGAGTAGGTCTTT	AAAGAGTAGGTCTTT	1	1
GGAGTAGTGTGATGG	GGAGTAGTGTGATGG	1	1
AAAATCAGCACAATG	AAAATCAGCACAATG	1	1
GAAGCTAAGTTTGTC	GAAGCTAAGTTTGTC	1	1
TAGTTGACTGAGTTA	TAGTTGACTGAGTTA	1	1
AGCGTCCTACATTTC	AGCGTCCTACATTTC	1	1
ATTGTTATGAAGTTG	ATTGTTATGAAGTTG	1	1
CGTGTCTTTCCGGAT	CGTGTCTTTCCGGAT	1	1
GTATTTGTTCATTTC	GTATTTGTTCATTTC	1	1
TGCTGTGTCTCGGTT	TGCTGTGTCTCGGTT	1	1
ATAGTGCATTCAACT	ATAGTGCATTCAACT	1	1
GAAGTTAAGACGGTG	GAAGTTAAGACGGTG	1	1
CACGCGCCTTAATCT	CACGCGCCTTAATCT	1	1
TTAAAGTTGGTCCAT	TTAAAGTTGGTCCAT	1	1
GTTATCACTAGGCTT	GTTATCACTAGGCTT	1	1
TTCAAGCGAATAACT	TTCAAGCGAATAACT	1	1
CCTGTAATGATCACC	CCTGTAATGATCACC	1	1
AAACTTAACTACCTA	AAACTTAACTACCTA	1	1
GTTAGTTTCGTGTCA	GTTAGTTTCGTGTCA	1	1
TGTTCGTGATACTAT	TGTTCGTGATACTAT	1	1
GTTCGGGGACGCACT	GTTCGGGGACGCACT	1	1
ATATAAAATATCAAT	ATATAAAATATCAAT	1	1
TTACTTGAATAAGCG	TTACTTGAATAAGCG	1	1
ATCGGGATAGTAACG	ATCGGGATAGTAACG	2	1
TCGTCCAAAGAACGC	TCGTCCAAAGAACGC	1	1
AACGACATTTAATTG	AACGACATTTAATTG	1	1
TAATGTTTATTCACT	TAATGTTTATTCACT	1	1
GGTCATATCGCACAG	GGTCATATCGCACAG	1	1
AATCTAGTATGTTAG	AATCTAGTATGTTAG	1	1
AGAAGATCTGACACG	AGAAGATCTGACACG	1	1
TTAGCCTTTTTGTAA	TTAGCCTTTTTGTAA	1	1
TATGACAAATCACTC	TATGACAAATCACTC	1	1
TGTCTGCATATCCGT	TGTCTGCATATCCGT	1	1
GGGGTGACGGGGCGT	GGGGTGACGGGGCGT	1	1
ATCCCGGTGTCCTGG	ATCCCGGTGTCCTGG	1	1
GGTAAGCTAGATGCA	GGTAAGCTAGATGCA	1	1
TTAAGGTTTTCGCAT	TTAAGGTTTTCGCAT	1	1
GCTTTTGGATGGGTT	GCTTTTGGATGGGTT	1	1
CGCTAGTAGGGTTAT	CGCTAGTAGGGTTAT	1	1
AACGACAGTACGCTG	AACGACAGTACGCTG	1	1
TGTTCTCACGACCAG	TGTTCTCACGACCAG	1	1
AGTAAGTCGAGCTGT	AGTAAGTCGAGCTGT	1	1
CTCAGGGTTTCTGTC	CTCAGGGTTTCTGTC	1	1
AAATTAGTATGGGGT	AAATTAGTATGGGGT	1	1
GTAGGTTGTATATCT	GTAGGTTGTATATCT	1	1
TTTAAATCAATTGCT	TTTAAATCAATTGCT	2	1
CACAGATGGTCTATG	CACAGATGGTCTATG	1	1
TTACTTAGATTTTTG	TTACTTAGATTTTTG	1	1
ATGTCGGAGGATTGT	ATGTCGGAGGATTGT	2	1
TATATCGGCAAGTGC	TATATCGGCAAGTGC	1	1
AAAACTAACCGATAC	AAAACTAACCGATAC	1	1
GCAATGATCTGTCTT	GCAATGATCTGTCTT	1	1
AACGAGGACAAACTT	AACGAGGACAAACTT	1	1
GATTCGGGGGTAGTT	GATTCGGGGGTAGTT	1	1
TAAAAAGTTACCTTT	TAAAAAGTTACCTTT	1	1
ATTATCACGAGTTAC	ATTATCACGAGTTAC	1	1
ATAACGCTATTTTAT	ATAACGCTATTTTAT	1	1
ATTGTATTCATATGG	ATTGTATTCATATGG	1	1
GGTATGTTCCAATCG	GGTATGTTCCAATCG	1	1
TGAGGTTATTTTTAT	TGAGGTTATTTTTAT	2	1
AGTTGGTATATTGAG	AGTTGGTATATTGAG	1	1
GACATGCTACATTTA	GACATGCTACATTTA	1	1
TTTCAACGGTATCTT	TTTCAACGGTATCTT	1	1
GCCTACGATATGCCT	GCCTACGATATGCCT	1	1
TTATTACAGTTTGGT	TTATTACAGTTTGGT	1	1
GATAATTCAGCAAAA	GATAATTCAGCAAAA	1	1
GGAGTGGGAAAGAAG	GGAGTGGGAAAGAAG	1	1
CTGTGTTTGCGCCTA	CTGTGTTTGCGCCTA	2	1
GAAGTGTCGACGTAT	GAAGTGTCGACGTAT	2	1
AACGGGCGCGACAAA	AACGGGCGCGACAAA	1	1
TTCGTACCCCCTACT	TTCGTACCCCCTACT	1	1
ACACAATAGGGAGAA	ACACAATAGGGAGAA	1	1
AATCAATTTTGTTCG	AATCAATTTTGTTCG	1	1
AACTCAGACGCTTAA	AACTCAGACGCTTAA	1	1
TGGTTGGGGGCGTGT	TGGTTGGGGGCGTGT	1	1
CTTAGCGGTGTATTT	CTTAGCGGTGTATTT	1	1
ATGACTTTGGGGAGA	ATGACTTTGGGGAGA	1	1
CCGTGTAGATATTAA	CCGTGTAGATATTAA	1	1
CACATATATAAACCT	CACATATATAAACCT	1	1
CGTCGATTCAGGCGA	CGTCGATTCAGGCGA	1	1
GTCGCGTTGGGTCTG	GTCGCGTTGGGTCTG	1	1
ATAGTATCGTGTATT	ATAGTATCGTGTATT	1	1
ATGATTATCGCCTTT	ATGATTATCGCCTTT	1	1
GGGCGGGGGGGGGCG	GGGCGGGGGGGGGCG	1	1
GGCGTCTCGGTTAAG	GGCGTCTCGGTTAAG	1	1
TAATCACGGGTGTAC	TAATCACGGGTGTAC	1	1
TCTTTACGAGGATTC	TCTTTACGAGGATTC	2	1
CCTTTGGATTATTGT	CCTTTGGATTATTGT	1	1
GTTTAGCATTTCAGT	GTTTAGCATTTCAGT	1	1
TATGGGCTAATACGA	TATGGGCTAATACGA	1	1
CATTGTGAGTAAATA	CATTGTGAGTAAATA	1	1
TTACGGTTATCTACT	TTACGGTTATCTACT	1	1
CCGCTGATTATATCA	CCGCTGATTATATCA	1	1
TAATCTTGTATTTCC	TAATCTTGTATTTCC	1	1
TTTGTTTCTGTAACT	TTTGTTTCTGTAACT	1	1
AGGAGGGCGGTGTGT	AGGAGGGCGGTGTGT	1	1
ACGAGGTACTTTTTT	ACGAGGTACTTTTTT	1	1
AAATAAACGTGGCTG	AAATAAACGTGGCTG	1	1
CGAGTCGACTGTCGG	CGAGTCGACTGTCGG	1	1
ATTCTCCGGCGTGTT	ATTCTCCGGCGTGTT	1	1
TCACAGTTCGTGTAA	TCACAGTTCGTGTAA	1	1
GCGGTATTACTGCCT	GCGGTATTACTGCCT	1	1
TGCGACCGAATTGGA	TGCGACCGAATTGGA	1	1
ATTTGATCAATTGAT	ATTTGATCAATTGAT	1	1
TCTAGTTTTCTAGAT	TCTAGTTTTCTAGAT	1	1
ATCGCCGTTGCTCCT	ATCGCCGTTGCTCCT	1	1
TACTCAGAAATTACA	TACTCAGAAATTACA	1	1
AGCTATTTGGTATTG	AGCTATTTGGTATTG	1	1
GAGTGGGTGTAGTGT	GAGTGGGTGTAGTGT	1	1
CATCAGACAAGGTCT	CATCAGACAAGGTCT	2	1
TTTATATATACCACA	TTTATATATACCACA	1	1
TATTCTCAAGACTAA	TATTCTCAAGACTAA	1	1
CTTTGGTCAATGGCA	CTTTGGTCAATGGCA	1	1
TAAATAATTATCTGA	TAAATAATTATCTGA	2	1
AAGTTGGCGTGTTTC	AAGTTGGCGTGTTTC	1	1
TCAGATGAATCATTT	TCAGATGAATCATTT	1	1
TAACTAGACTAACCT	TAACTAGACTAACCT	1	1
GTTCTATCATGGATT	GTTCTATCATGGATT	1	1
TTTGTGCTTTTAGCG	TTTGTGCTTTTAGCG	1	1
GGCTGGTGATAATAC	GGCTGGTGATAATAC	1	1
AGAGGCTGATGCATT	AGAGGCTGATGCATT	1	1
AGGCAGAAAATAGTC	AGGCAGAAAATAGTC	1	1
TGATTCACTAGGTGA	TGATTCACTAGGTGA	1	1
ATCCGAGTATTCTAA	ATCCGAGTATTCTAA	1	1
TTTTATACACTAAAG	TTTTATACACTAAAG	1	1
ATACCGCCGGCTTCA	ATACCGCCGGCTTCA	1	1
TGTGCTCGGCTAGCA	TGTGCTCGGCTAGCA	1	1
TTCCTACACTTATAA	TTCCTACACTTATAA	1	1
TACGTGTATTCATAT	TACGTGTATTCATAT	1	1
TATTAAGTTCTTACT	TATTAAGTTCTTACT	1	1
ATCTTATTAAAGAAA	ATCTTATTAAAGAAA	1	1
GTAGTTAGGTAGTTG	GTAGTTAGGTAGTTG	1	1
TCTGAGACCAGCGTT	TCTGAGACCAGCGTT	1	1
TGATGAGCAGCATCA	TGATGAGCAGCATCA	1	1
GCGCGGCCGGTGTGC	GCGCGGCCGGTGTGC	1	1
TTATGACCTTGACTT	TTATGACCTTGACTT	2	1
TTATGGTGATTGTAA	TTATGGTGATTGTAA	1	1
ATGGAAAGCTACCTT	ATGGAAAGCTACCTT	1	1
AGCTTAAATTCCTCA	AGCTTAAATTCCTCA	1	1
CTGCAGTTACCTGTA	CTGCAGTTACCTGTA	1	1
ACTCATATTATTCGT	ACTCATATTATTCGT	1	1
GCAAATCTTCGTATT	GCAAATCTTCGTATT	1	1
CTAACTCGTATTCTT	CTAACTCGTATTCTT	1	1
TCCTATCTTAATGGA	TCCTATCTTAATGGA	1	1
CACCCTGGTGAATCT	CACCCTGGTGAATCT	1	1
ATAGTCCTGCGAAAG	ATAGTCCTGCGAAAG	1	1
CTACGCCCAATTATA	CTACGCCCAATTATA	1	1
CCTCGCTGCAGGGGA	CCTCGCTGCAGGGGA	1	1
CGGGTTGTTTGTCAA	CGGGTTGTTTGTCAA	1	1
TATCCACAGTATATA	TATCCACAGTATATA	1	1
AGTGGCTTAATGGTA	AGTGGCTTAATGGTA	2	1
GCGCAGTGTGTTTCG	GCGCAGTGTGTTTCG	1	1
AGCGGGAACCGCGTG	AGCGGGAACCGCGTG	1	1
GAAGTCTGTATTTGT	GAAGTCTGTATTTGT	1	1
CTTTGTGTGTGTCTA	CTTTGTGTGTGTCTA	1	1
GGGCCACAGTTATGG	GGGCCACAGTTATGG	1	1
GTCACACCCAATCGG	GTCACACCCAATCGG	1	1
GTCTTCTTTTCTACT	GTCTTCTTTTCTACT	1	1
GATCTCGCTTAGGTT	GATCTCGCTTAGGTT	1	1
TTTAGCACCTCTATG	TTTAGCACCTCTATG	1	1
TCTGGGTCAGGAGGA	TCTGGGTCAGGAGGA	1	1
TTTGATCCGTTATTC	TTTGATCCGTTATTC	1	1
GCACAACAGTTTCCT	GCACAACAGTTTCCT	1	1
CCTTATTTATTAGAG	CCTTATTTATTAGAG	1	1
TTACGTGTAATGTGT	TTACGTGTAATGTGT	1	1
CAATATTTAGCCTTT	CAATATTTAGCCTTT	1	1
GAAAGTGTTTTACGT	GAAAGTGTTTTACGT	1	1
CTACTGGGCGTGCTT	CTACTGGGCGTGCTT	2	1
TTTTTATAGGCGATT	TTTTTATAGGCGATT	1	1
AATACTGTCCGCGAC	AATACTGTCCGCGAC	1	1
CCGGTTAAATCGCCC	CCGGTTAAATCGCCC	1	1
GCCTACCCTTTAGTG	GCCTACCCTTTAGTG	1	1
TCAGTTCTAGTCTAT	TCAGTTCTAGTCTAT	1	1
ATTAGGACGAAAATT	ATTAGGACGAAAATT	1	1
AGCTGAGGGGAAGTT	AGCTGAGGGGAAGTT	1	1
AATCACTTTGCGTAT	AATCACTTTGCGTAT	1	1
CGGGTTGCGTAATGT	CGGGTTGCGTAATGT	1	1
GAGGGTGCTGGGGTC	GAGGGTGCTGGGGTC	1	1
GCACGTTACTCGTTG	GCACGTTACTCGTTG	1	1
GTCTCTGGTTAGATC	GTCTCTGGTTAGATC	1	1
CACAATTGTATAACC	CACAATTGTATAACC	1	1
AACAGCTGCACTCAT	AACAGCTGCACTCAT	1	1
TCTCTCTGCTATTTT	TCTCTCTGCTATTTT	1	1
TATGCATCGATGGTA	TATGCATCGATGGTA	1	1
CCACACAATCACTTT	CCACACAATCACTTT	1	1
CTCTCGGTTTTACCT	CTCTCGGTTTTACCT	1	1
CAACACATCTTATGC	CAACACATCTTATGC	1	1
ATATTTGTTCAAGGC	ATATTTGTTCAAGGC	1	1
ATTGCTTGTTTAGTG	ATTGCTTGTTTAGTG	1	1
CGTCGCTATAGTCTA	CGTCGCTATAGTCTA	1	1
AAGTAGATTCCCTCC	AAGTAGATTCCCTCC	1	1
GTACCATTGGATTAA	GTACCATTGGATTAA	1	1
TTTCCTGACGGTTTT	TTTCCTGACGGTTTT	1	1
TAAGTCAAACTTTAC	TAAGTCAAACTTTAC	1	1
GCTGTTGTAACTATA	GCTGTTGTAACTATA	1	1
TTCAGGTGGTGGGTG	TTCAGGTGGTGGGTG	1	1
AGTAATCAGATACTT	AGTAATCAGATACTT	1	1
GTTTAGAATGATCAA	GTTTAGAATGATCAA	1	1
GGAGGGATGTCTAGT	GGAGGGATGTCTAGT	1	1
ATGGTAGTCGTACTA	ATGGTAGTCGTACTA	1	1
TCTTTCCATTAGTAA	TCTTTCCATTAGTAA	1	1
GTCGTGGTGTTTTAT	GTCGTGGTGTTTTAT	1	1
TGAAAATTTTTCCTT	TGAAAATTTTTCCTT	1	1
GGTCTCGTGATGCTT	GGTCTCGTGATGCTT	1	1
ATACCGAGGGCAACA	ATACCGAGGGCAACA	1	1
CGCTTATTATACACA	CGCTTATTATACACA	1	1
AATAGTAATACGGTC	AATAGTAATACGGTC	1	1
ATGTGGTAAGAGCGT	ATGTGGTAAGAGCGT	1	1
AAATTAAGCTTGCTG	AAATTAAGCTTGCTG	1	1
TTTTGTTATTACCGT	TTTTGTTATTACCGT	1	1
CACTTGTCAGACAGA	CACTTGTCAGACAGA	1	1
CAGAAAGGTTTTTCG	CAGAAAGGTTTTTCG	1	1
TTTAGATCAGAGAGA	TTTAGATCAGAGAGA	1	1
TAGAAAACATCAGTA	TAGAAAACATCAGTA	1	1
TAGTTCCGGTATGCA	TAGTTCCGGTATGCA	1	1
CCAAATTGTTACGTT	CCAAATTGTTACGTT	1	1
GTGTGTGCACTAGTG	GTGTGTGCACTAGTG	1	1
TCTAGTGGGTTTTAG	TCTAGTGGGTTTTAG	1	1
GCAAACGGGGACCTT	GCAAACGGGGACCTT	1	1
AATCCCTTAGTTTCT	AATCCCTTAGTTTCT	1	1
CTAGGAGAGTTTCAC	CTAGGAGAGTTTCAC	1	1
CACTTCTGTAACACG	CACTTCTGTAACACG	1	1
ATAAGACTTTCGTTT	ATAAGACTTTCGTTT	1	1
GTAAGTTCGTTGACT	GTAAGTTCGTTGACT	1	1
CGTGATATACGAAAA	CGTGATATACGAAAA	1	1
AAGCTCTGGCTTTAT	AAGCTCTGGCTTTAT	1	1
GGCTTTACGTCTCTA	GGCTTTACGTCTCTA	1	1
TAACATTTCGTTTTT	TAACATTTCGTTTTT	1	1
CCCGTGCCTTCGCAT	CCCGTGCCTTCGCAT	1	1
GATTACGGTCTTAAT	GATTACGGTCTTAAT	1	1
TCAGTTTGTAGGGTG	TCAGTTTGTAGGGTG	1	1
TTCCTGTTCCTTTAC	TTCCTGTTCCTTTAC	1	1
TATGGTTTGCGGTAG	TATGGTTTGCGGTAG	1	1
CCTCGCTTGAACCGT	CCTCGCTTGAACCGT	1	1
AATTTAAATCAAATA	AATTTAAATCAAATA	1	1
GCGGGTGGCCTGATG	GCGGGTGGCCTGATG	1	1
TTTAGTTAGGAATGC	TTTAGTTAGGAATGC	1	1
TCTTATGACGGATTG	TCTTATGACGGATTG	1	1
TCCTGGTTCTCTGAT	TCCTGGTTCTCTGAT	2	1
ACCGATTTAATTTCG	ACCGATTTAATTTCG	1	1
TATGGACTTACTAAA	TATGGACTTACTAAA	1	1
TTATGAATAATACTT	TTATGAATAATACTT	1	1
AATACTGACTACAAT	AATACTGACTACAAT	1	1
ACTGTACAGGCTCCG	ACTGTACAGGCTCCG	1	1
TCGGTATGTTTCTTG	TCGGTATGTTTCTTG	1	1
ATTGGCAATAAGCAG	ATTGGCAATAAGCAG	1	1
AGTATTTTTTCAATT	AGTATTTTTTCAATT	1	1
ATCCTGGTCAAGATA	ATCCTGGTCAAGATA	1	1
TTATGGCGCGCGTCA	TTATGGCGCGCGTCA	1	1
AATCGTTAGTAGGTT	AATCGTTAGTAGGTT	1	1
TTGGGTCCGGTCACG	TTGGGTCCGGTCACG	1	1
CATTTATCATTTTGT	CATTTATCATTTTGT	1	1
ATTTCTGTACAGTTT	ATTTCTGTACAGTTT	1	1
GTTTTAGGTATAGCG	GTTTTAGGTATAGCG	1	1
TAAGCAAAGTCAGAG	TAAGCAAAGTCAGAG	1	1
ATTTAGGGGGGCTGT	ATTTAGGGGGGCTGT	2	1
ACAGTCAAACAATTA	ACAGTCAAACAATTA	1	1
TTGGGCGGCTACTTG	TTGGGCGGCTACTTG	1	1
GAAGGGAGGCAGGTC	GAAGGGAGGCAGGTC	1	1
TGCTTCCATCGTATA	TGCTTCCATCGTATA	1	1
GCTAGCCATGTCAGT	GCTAGCCATGTCAGT	1	1
TGACGGTGATTGTAT	TGACGGTGATTGTAT	1	1
TATGGGAACGTTCTC	TATGGGAACGTTCTC	1	1
ACGTTATTCTATATT	ACGTTATTCTATATT	1	1
CCCAGTTTCATCGTA	CCCAGTTTCATCGTA	1	1
GGCCGGGTGATGCGT	GGCCGGGTGATGCGT	1	1
AAGATCGGCTTTAGA	AAGATCGGCTTTAGA	1	1
GGATCGAAATACCAG	GGATCGAAATACCAG	1	1
TGGAATTCTTTAAGT	TGGAATTCTTTAAGT	1	1
GTACTAGGCCTCGTA	GTACTAGGCCTCGTA	1	1
GTGGAAGTACTCCGT	GTGGAAGTACTCCGT	1	1
TTAGACTGTGTGTGT	TTAGACTGTGTGTGT	1	1
TATAGTACCTTAAAG	TATAGTACCTTAAAG	1	1
ATTATTACCGAAGTT	ATTATTACCGAAGTT	1	1
GAAGAGTGCGCCTGG	GAAGAGTGCGCCTGG	1	1
TTTATACTTCTTTCT	TTTATACTTCTTTCT	1	1
GCCGTAGGCCGGTCT	GCCGTAGGCCGGTCT	1	1
CTTGAACGTTTGTGG	CTTGAACGTTTGTGG	1	1
TGGATAGGGTTTGCG	TGGATAGGGTTTGCG	1	1
TGACGTAGTTGAGCG	TGACGTAGTTGAGCG	1	1
ATAATTCAGTGTTTG	ATAATTCAGTGTTTG	1	1
AGACTAACCCTCAAA	AGACTAACCCTCAAA	1	1
TCAGGATTGGGATTT	TCAGGATTGGGATTT	1	1
CTCTGAGTTGCCCTT	CTCTGAGTTGCCCTT	1	1
TCGTGTAAGTGACTT	TCGTGTAAGTGACTT	1	1
TTCCTCTTAGTGTTA	TTCCTCTTAGTGTTA	1	1
ATTCTTGAGTAGTAC	ATTCTTGAGTAGTAC	2	1
TGTATAAGTCTCGGT	TGTATAAGTCTCGGT	1	1
GTCCAAGTAGCACAG	GTCCAAGTAGCACAG	1	1
AGTTATCACTAGTAA	AGTTATCACTAGTAA	1	1
TCGAGTGATAAGCGC	TCGAGTGATAAGCGC	1	1
CATTGCTTATCTCTC	CATTGCTTATCTCTC	1	1
TGGGGGATTTATTAG	TGGGGGATTTATTAG	1	1
ATTGTATAGAATCAT	ATTGTATAGAATCAT	1	1
CCACATGAAATCACT	CCACATGAAATCACT	1	1
ACCTCTGAACCTTGG	ACCTCTGAACCTTGG	1	1
TCAGATGTCAATCAT	TCAGATGTCAATCAT	1	1
AAATCTTTACCAGTT	AAATCTTTACCAGTT	1	1
CGCGGATAAATGTGC	CGCGGATAAATGTGC	1	1
TACTGCCCTTAGCTG	TACTGCCCTTAGCTG	1	1
TGACTGCACGAATTG	TGACTGCACGAATTG	1	1
CAACGTACAAATAAT	CAACGTACAAATAAT	1	1
AGTGAATCGTGTGAT	AGTGAATCGTGTGAT	1	1
GTCCGGGGTAGTCCC	GTCCGGGGTAGTCCC	1	1
GAGTTACTTGTAGGA	GAGTTACTTGTAGGA	1	1
GACTTCTATTTGTGT	GACTTCTATTTGTGT	1	1
GAACTTTACTCCCTA	GAACTTTACTCCCTA	1	1
TGCGTGAAAGAGCTT	TGCGTGAAAGAGCTT	1	1
CGGGACAATTCCTTC	CGGGACAATTCCTTC	1	1
TGAATTAAATTCTCC	TGAATTAAATTCTCC	1	1
TACTCAAACGACGTA	TACTCAAACGACGTA	1	1
CATTAGTAGGCGTAA	CATTAGTAGGCGTAA	1	1
GCTAATGCATCATAA	GCTAATGCATCATAA	1	1
AGTCTTGTAGAGGGG	AGTCTTGTAGAGGGG	1	1
GCCTGGCGGAGCGGG	GCCTGGCGGAGCGGG	1	1
TCATATTGTATGGTC	TCATATTGTATGGTC	1	1
CAATGAGTAGTTTCA	CAATGAGTAGTTTCA	1	1
AGTGACAATTTATTG	AGTGACAATTTATTG	1	1
GAGTTCAAGTTTGAA	GAGTTCAAGTTTGAA	1	1
AAAGACCTGGACTTT	AAAGACCTGGACTTT	1	1
AAAAATTGCTAAGCT	AAAAATTGCTAAGCT	1	1
CAATTACAAACCGTG	CAATTACAAACCGTG	1	1
TTTATCCCGTATACG	TTTATCCCGTATACG	1	1
TAAAAAATCTTTGGA	TAAAAAATCTTTGGA	1	1
CTTCATAGGCAATCG	CTTCATAGGCAATCG	1	1
GGACAGCAGAAGAAA	GGACAGCAGAAGAAA	1	1
GCTGGCTATGTTCTT	GCTGGCTATGTTCTT	1	1
AAAGTAGTATACTCT	AAAGTAGTATACTCT	1	1
GAAGGTGGTGGGTTG	GAAGGTGGTGGGTTG	1	1
CCTCCGGTTACGTCT	CCTCCGGTTACGTCT	1	1
CCATACGTCCCACAA	CCATACGTCCCACAA	1	1
ATCGTCCAACATAAC	ATCGTCCAACATAAC	1	1
TGCCGTTGTGTTAGT	TGCCGTTGTGTTAGT	1	1
GGGTTATCATGTCGG	GGGTTATCATGTCGG	1	1
GACAGACTTTAACTG	GACAGACTTTAACTG	1	1
ATTCTATGCCTAACA	ATTCTATGCCTAACA	1	1
CTTTCAGTTTGTGTA	CTTTCAGTTTGTGTA	1	1
CACTGAGGGTTTAAA	CACTGAGGGTTTAAA	1	1
ATTTCCGTCAAAGTA	ATTTCCGTCAAAGTA	1	1
CCCTCATCATGTGTT	CCCTCATCATGTGTT	1	1
AAACTTCTTTTTGAC	AAACTTCTTTTTGAC	1	1
TTCTTTGATTATTGT	TTCTTTGATTATTGT	1	1
GCATTCATTCATGTC	GCATTCATTCATGTC	1	1
ATATGTGGTATTTTG	ATATGTGGTATTTTG	1	1
AGTTCTTAACATACA	AGTTCTTAACATACA	1	1
ATACCTATCATAATT	ATACCTATCATAATT	1	1
ATGGACCTAAATATT	ATGGACCTAAATATT	1	1
CATTCTATACTTTGC	CATTCTATACTTTGC	1	1
TCTCAGGAATGCACG	TCTCAGGAATGCACG	1	1
TTTCATGAAAGGAGT	TTTCATGAAAGGAGT	1	1
GTCGGTCTCGCGCCG	GTCGGTCTCGCGCCG	1	1
CGCTATGTTAGCATA	CGCTATGTTAGCATA	1	1
GCCGGGGGTTTCGTT	GCCGGGGGTTTCGTT	1	1
AAATATCAGTAATTC	AAATATCAGTAATTC	1	1
